cellname	celltype
AAACATACAACCAC-1	T cell
AAACATTGAGCTAC-1	B cell
AAACATTGATCAGC-1	T cell
AAACCGTGCTTCCG-1	Monocyte
AAACCGTGTATGCG-1	NK cell
AAACGCACTGGTAC-1	T cell
AAACGCTGACCAGT-1	T cell
AAACGCTGGTTCTT-1	T cell
AAACGCTGTAGCCA-1	T cell
AAACGCTGTTTCTG-1	Granulocyte
AAACTTGAAAAACG-1	B cell
AAACTTGATCCAGA-1	T cell
AAAGAGACGAGATA-1	T cell
AAAGAGACGCGAGA-1	Monocyte
AAAGAGACGGACTT-1	T cell
AAAGAGACGGCATT-1	T cell
AAAGATCTGGGCAA-1	Monocyte
AAAGCAGAAGCCAT-1	T cell
AAAGCAGATATCGG-1	Monocyte
AAAGCCTGTATGCG-1	T cell
AAAGGCCTGTCTAG-1	B cell
AAAGTTTGATCACG-1	B cell
AAAGTTTGGGGTGA-1	B cell
AAAGTTTGTAGAGA-1	T cell
AAAGTTTGTAGCGT-1	Monocyte
AAATCAACAATGCC-1	B cell
AAATCAACACCAGT-1	T cell
AAATCAACCAGGAG-1	T cell
AAATCAACCCTATT-1	Monocyte
AAATCAACGGAAGC-1	T cell
AAATCAACTCGCAA-1	T cell
AAATCATGACCACA-1	Monocyte
AAATCCCTCCACAA-1	T cell
AAATCCCTGCTATG-1	B cell
AAATGTTGAACGAA-1	Monocyte
AAATGTTGCCACAA-1	T cell
AAATGTTGTGGCAT-1	Monocyte
AAATTCGAAGGTTC-1	T cell
AAATTCGAATCACG-1	Monocyte
AAATTCGAGCTGAT-1	Monocyte
AAATTCGAGGAGTG-1	T cell
AAATTCGATTCTCA-1	NK cell
AAATTGACACGACT-1	T cell
AAATTGACTCGCTC-1	T cell
AACAAACTCATTTC-1	T cell
AACAAACTTTCGTT-1	T cell
AACAATACGACGAG-1	T cell
AACACGTGCAGAGG-1	T cell
AACACGTGGAAAGT-1	T cell
AACACGTGGAACCT-1	Monocyte
AACACGTGGCTACA-1	T cell
AACACGTGTACGAC-1	Monocyte
AACAGCACAAGAGT-1	Granulocyte
AACATTGATGGGAG-1	Monocyte
AACCAGTGATACCG-1	Monocyte
AACCCAGATCGCTC-1	B cell
AACCGATGCTCCCA-1	T cell
AACCGATGGTCATG-1	B cell
AACCGATGTTCTAC-1	Monocyte
AACCGCCTAGCGTT-1	T cell
AACCGCCTCTACGA-1	Monocyte
AACCTACTGTGAGG-1	Monocyte
AACCTACTGTGTTG-1	T cell
AACCTTACGAGACG-1	T cell
AACCTTACGCGAGA-1	NK cell
AACCTTACTAACGC-1	Monocyte
AACCTTTGGACGGA-1	T cell
AACCTTTGTACGCA-1	Monocyte
AACGCAACAAGTAG-1	T cell
AACGCATGACCCAA-1	T cell
AACGCATGCCTTCG-1	T cell
AACGCATGTACTTC-1	T cell
AACGCCCTCGGGAA-1	T cell
AACGCCCTCGTACA-1	NK cell
AACGCCCTGCTTAG-1	B cell
AACGCCCTGGCATT-1	T cell
AACGTCGAGTATCG-1	T cell
AACGTGTGAAAGCA-1	T cell
AACGTGTGGCGGAA-1	B cell
AACGTGTGTCCAAG-1	T cell
AACGTGTGTGCTTT-1	Monocyte
AACTACCTTAGAGA-1	B cell
AACTCACTCAAGCT-1	Monocyte
AACTCACTTGGAGG-1	Monocyte
AACTCGGAAAGTGA-1	T cell
AACTCGGAAGGTCT-1	Monocyte
AACTCTTGCAGGAG-1	T cell
AACTGTCTCCCTTG-1	Monocyte
AACTTGCTACGCTA-1	B cell
AACTTGCTGGGACA-1	T cell
AAGAACGAGTGTTG-1	T cell
AAGAAGACGTAGGG-1	B cell
AAGACAGAAGTCTG-1	B cell
AAGACAGAGGATCT-1	T cell
AAGACAGATTACCT-1	Monocyte
AAGAGATGGGTAGG-1	B cell
AAGATGGAAAACAG-1	B cell
AAGATGGAGAACTC-1	Monocyte
AAGATGGAGATAAG-1	Monocyte
AAGATTACAACCTG-1	T cell
AAGATTACAGATCC-1	Monocyte
AAGATTACCCGTTC-1	Monocyte
AAGATTACCGCCTT-1	B cell
AAGATTACCTCAAG-1	NK cell
AAGATTACTCCTCG-1	Monocyte
AAGCAAGAGCGAGA-1	T cell
AAGCAAGAGCTTAG-1	T cell
AAGCAAGAGGTGTT-1	NK cell
AAGCACTGAGCAAA-1	B cell
AAGCACTGCATACG-1	NK cell
AAGCACTGGTTCTT-1	T cell
AAGCCAACGTGTTG-1	T cell
AAGCCATGAACTGC-1	B cell
AAGCCATGACACGT-1	Monocyte
AAGCCATGCGTGAT-1	B cell
AAGCCATGTCTCGC-1	T cell
AAGCCTGACATGCA-1	T cell
AAGCCTGACCGAAT-1	B cell
AAGCGACTCCTCAC-1	Monocyte
AAGCGACTGTGTCA-1	T cell
AAGCGACTTACAGC-1	B cell
AAGCGACTTTGACG-1	Monocyte
AAGCGTACGTCTTT-1	T cell
AAGGCTTGCGAACT-1	T cell
AAGGTCACGGTTAC-1	Monocyte
AAGGTCACTGTTTC-1	B cell
AAGGTCACTTCCCG-1	T cell
AAGGTCTGACAGTC-1	T cell
AAGGTCTGCAGATC-1	T cell
AAGGTCTGGTATGC-1	Monocyte
AAGTAACTCTGAAC-1	B cell
AAGTAACTGAGATA-1	B cell
AAGTAGGATACAGC-1	NK cell
AAGTATACCGAACT-1	T cell
AAGTCCGACTTGTT-1	T cell
AAGTCCGATAGAAG-1	T cell
AAGTCTCTAGTCGT-1	T cell
AAGTCTCTCGGAGA-1	B cell
AAGTGGCTTGGAGG-1	B cell
AAGTTCCTCATTCT-1	Monocyte
AAGTTCCTTCTTAC-1	T cell
AATAAGCTCGAATC-1	T cell
AATAAGCTCGTTGA-1	T cell
AATACCCTGGACGA-1	T cell
AATACCCTGGCATT-1	T cell
AATACTGAAAGGGC-1	NK cell
AATACTGAATTGGC-1	NK cell
AATAGGGAACCCTC-1	B cell
AATAGGGAGAATGA-1	T cell
AATCAAACTATCGG-1	T cell
AATCCGGAATGCTG-1	B cell
AATCCTACCGGTAT-1	T cell
AATCCTTGACGGGA-1	Monocyte
AATCCTTGGTGAGG-1	T cell
AATCGGTGGAACTC-1	NK cell
AATCGGTGTGCTTT-1	T cell
AATCTAGAAAAGTG-1	T cell
AATCTAGAATCGGT-1	T cell
AATCTCACAGCCTA-1	Monocyte
AATCTCACTCTAGG-1	T cell
AATCTCTGAACAGA-1	T cell
AATCTCTGCTTTAC-1	NK cell
AATGATACACCAAC-1	T cell
AATGATACGGTCAT-1	Monocyte
AATGCGTGACACCA-1	B cell
AATGCGTGGACGGA-1	Monocyte
AATGCGTGGCTATG-1	B cell
AATGGAGAATCGTG-1	Monocyte
AATGGAGATCCTTA-1	T cell
AATGGCTGACACCA-1	B cell
AATGGCTGCGTGAT-1	T cell
AATGGCTGTAAAGG-1	T cell
AATGGCTGTACTCT-1	T cell
AATGGCTGTGAAGA-1	T cell
AATGTAACGGTGGA-1	T cell
AATGTAACGTTTGG-1	T cell
AATGTCCTCTTCTA-1	T cell
AATGTTGACAGTCA-1	T cell
AATGTTGAGTTGAC-1	Monocyte
AATGTTGATCTACT-1	T cell
AATTACGAATTCCT-1	Monocyte
AATTACGACTTCTA-1	T cell
AATTACGAGTAGCT-1	T cell
AATTACGAGTGAGG-1	T cell
AATTACGATTGGCA-1	B cell
AATTCCTGCTCAGA-1	B cell
AATTGATGTCGCAA-1	Monocyte
AATTGTGACTTGGA-1	T cell
ACAAAGGAGGGTGA-1	T cell
ACAAATTGATTCTC-1	Monocyte
ACAAATTGCTCAGA-1	Monocyte
ACAAATTGTTGCGA-1	T cell
ACAACCGAGGGATG-1	T cell
ACAACCGAGTTACG-1	T cell
ACAAGAGAAGTCGT-1	Monocyte
ACAAGAGACTTATC-1	T cell
ACAAGAGAGTTGAC-1	B cell
ACAATCCTAACCGT-1	T cell
ACAATCCTTAGCGT-1	B cell
ACAATTGACTGACA-1	T cell
ACAATTGATGACTG-1	NK cell
ACACAGACACCTGA-1	Monocyte
ACACAGACCATACG-1	NK cell
ACACCAGAGGGCAA-1	T cell
ACACCCTGGTGTTG-1	NK cell
ACACGAACAGTTCG-1	T cell
ACACGATGACGCAT-1	T cell
ACACGATGATGTGC-1	Monocyte
ACACGATGTCGTAG-1	T cell
ACACGATGTGGTCA-1	T cell
ACAGACACGGCATT-1	T cell
ACAGACACGTTGTG-1	T cell
ACAGCAACACCTAG-1	Monocyte
ACAGCAACCTCAAG-1	Monocyte
ACAGGTACCCCACT-1	T cell
ACAGGTACGCTGTA-1	T cell
ACAGGTACTGGTGT-1	T cell
ACAGTCGACCCAAA-1	T cell
ACAGTCGACCGATA-1	T cell
ACAGTGACTCACCC-1	T cell
ACAGTGACTCTATC-1	T cell
ACAGTGTGGTCACA-1	T cell
ACAGTGTGTTGCGA-1	Monocyte
ACATCACTCTACTT-1	Monocyte
ACATGGTGAAGCCT-1	T cell
ACATGGTGCAACCA-1	B cell
ACATGGTGCGAGTT-1	T cell
ACATGGTGCGTTGA-1	NK cell
ACATTCTGGCATAC-1	T cell
ACATTCTGGGAACG-1	Monocyte
ACCAACGACATGCA-1	T cell
ACCACAGAAAGTAG-1	T cell
ACCACAGAGTTGGT-1	T cell
ACCACCTGTGTGCA-1	Monocyte
ACCACGCTACAGCT-1	T cell
ACCACGCTACCCAA-1	NK cell
ACCACGCTGCGAGA-1	T cell
ACCACGCTGCTGTA-1	T cell
ACCAGCCTGACAGG-1	T cell
ACCAGTGAACGGTT-1	B cell
ACCAGTGAATACCG-1	Monocyte
ACCAGTGAGGGATG-1	T cell
ACCAGTGATGACTG-1	Monocyte
ACCATTACCTTCTA-1	T cell
ACCATTACGAGATA-1	T cell
ACCATTTGTCATTC-1	T cell
ACCCAAGAACTGTG-1	T cell
ACCCAAGAATTCCT-1	Monocyte
ACCCAAGAGGACAG-1	T cell
ACCCAAGATTCACT-1	B cell
ACCCACTGCGCCTT-1	Monocyte
ACCCACTGGACAGG-1	T cell
ACCCACTGGTTCAG-1	Monocyte
ACCCACTGTCGTAG-1	Monocyte
ACCCAGCTCAGAAA-1	T cell
ACCCAGCTGTTAGC-1	Monocyte
ACCCAGCTTGCTTT-1	T cell
ACCCGTTGATGACC-1	B cell
ACCCGTTGCTGCAA-1	T cell
ACCCGTTGCTTCTA-1	T cell
ACCCTCGACCTATT-1	T cell
ACCCTCGACGGTAT-1	T cell
ACCCTCGATAAGGA-1	Monocyte
ACCCTCGATCAAGC-1	Monocyte
ACCGTGCTACCAGT-1	T cell
ACCGTGCTGGAACG-1	B cell
ACCTATTGCTGAGT-1	B cell
ACCTATTGTGCCCT-1	Monocyte
ACCTCCGAGTCCTC-1	T cell
ACCTCCGATATGCG-1	T cell
ACCTCCGATGCTGA-1	B cell
ACCTCGTGAACCAC-1	T cell
ACCTGAGATATCGG-1	Monocyte
ACCTGGCTAAGTAG-1	T cell
ACCTGGCTGTCTTT-1	Monocyte
ACCTTTGACTCCCA-1	Monocyte
ACCTTTGAGGAACG-1	Monocyte
ACCTTTGAGGAAGC-1	Monocyte
ACGAACACCTTGTT-1	NK cell
ACGAACTGGCTATG-1	Monocyte
ACGAAGCTCTCCAC-1	T cell
ACGAAGCTCTGAGT-1	B cell
ACGACCCTATCTCT-1	Monocyte
ACGACCCTGATGAA-1	T cell
ACGACCCTTGACAC-1	B cell
ACGACCCTTGACCA-1	T cell
ACGAGGGACAGGAG-1	B cell
ACGAGGGACGAACT-1	T cell
ACGAGGGATGTAGC-1	T cell
ACGAGTACCCTAAG-1	B cell
ACGAGTACGAATCC-1	B cell
ACGATCGAGGACTT-1	Monocyte
ACGATCGAGTCACA-1	Monocyte
ACGATGACAATGCC-1	T cell
ACGATGACTGGTCA-1	T cell
ACGATTCTACGGGA-1	T cell
ACGCAATGGTTCAG-1	NK cell
ACGCACCTGTTAGC-1	B cell
ACGCCACTGAACTC-1	B cell
ACGCCGGAAACCAC-1	Monocyte
ACGCCGGAAAGCCT-1	T cell
ACGCCGGAAATGCC-1	T cell
ACGCCTTGCTCCCA-1	Monocyte
ACGCGGTGGCGAGA-1	T cell
ACGCGGTGTGTGGT-1	B cell
ACGCGGTGTTTGCT-1	T cell
ACGCTCACAGTACC-1	T cell
ACGCTCACCCTTGC-1	T cell
ACGCTGCTGTTCTT-1	T cell
ACGGAACTCAGATC-1	NK cell
ACGGAACTGTCGTA-1	Monocyte
ACGGAGGACTCTTA-1	Monocyte
ACGGATTGGGAGGT-1	B cell
ACGGATTGGTTAGC-1	T cell
ACGGCTCTGAGCAG-1	T cell
ACGGCTCTTGCACA-1	T cell
ACGGTAACCGCTAA-1	T cell
ACGGTAACCTTCGC-1	T cell
ACGGTAACGGTGGA-1	T cell
ACGGTAACTCGCAA-1	T cell
ACGGTATGAGTCGT-1	Monocyte
ACGGTATGGGTATC-1	B cell
ACGGTATGGTTGTG-1	B cell
ACGGTCCTAACGGG-1	T cell
ACGGTCCTCGGGAA-1	T cell
ACGTAGACAACCAC-1	T cell
ACGTAGACTACAGC-1	B cell
ACGTCAGAAACGAA-1	T cell
ACGTCAGAGAGCTT-1	Monocyte
ACGTCAGAGGGATG-1	T cell
ACGTCCTGATAAGG-1	Monocyte
ACGTCCTGTGAACC-1	Monocyte
ACGTCGCTCCTGAA-1	T cell
ACGTCGCTCTATTC-1	Monocyte
ACGTCGCTTCTCAT-1	B cell
ACGTGATGCCATGA-1	Monocyte
ACGTGATGGGTCTA-1	T cell
ACGTGATGTAACCG-1	Monocyte
ACGTGATGTGACAC-1	NK cell
ACGTGCCTCCGTAA-1	T cell
ACGTGCCTTCTATC-1	T cell
ACGTTACTTTCCAT-1	T cell
ACGTTGGAAAAGCA-1	B cell
ACGTTGGAAACCTG-1	T cell
ACGTTGGACCGTAA-1	Monocyte
ACGTTGGAGCCAAT-1	NK cell
ACGTTGGATATGGC-1	B cell
ACGTTGGATCAGGT-1	Monocyte
ACGTTTACATCAGC-1	T cell
ACTAAAACCCACAA-1	T cell
ACTAAAACTCGACA-1	Monocyte
ACTACGGAATTTCC-1	T cell
ACTACGGACCTATT-1	T cell
ACTACGGATCGCTC-1	T cell
ACTACTACTAAGGA-1	T cell
ACTAGGTGGAACCT-1	T cell
ACTAGGTGGAACTC-1	T cell
ACTATCACCTTGGA-1	T cell
ACTATCACTGCCAA-1	T cell
ACTCAGGACTGAAC-1	T cell
ACTCAGGATCTATC-1	B cell
ACTCAGGATTCGTT-1	Monocyte
ACTCCTCTCAACTG-1	T cell
ACTCGCACGAAAGT-1	Monocyte
ACTCGCACTACGAC-1	Monocyte
ACTCTCCTGACACT-1	T cell
ACTCTCCTGCATAC-1	T cell
ACTCTCCTGTTTGG-1	T cell
ACTGAGACAACCAC-1	T cell
ACTGAGACCCATAG-1	Monocyte
ACTGAGACGTTGGT-1	B cell
ACTGCCACACACGT-1	T cell
ACTGCCACTCCGTC-1	NK cell
ACTGGCCTTCAGTG-1	NK cell
ACTGTGGACGTGTA-1	T cell
ACTGTGGATCTAGG-1	B cell
ACTGTTACCCACAA-1	Monocyte
ACTGTTACTGCAGT-1	T cell
ACTTAAGAACCACA-1	T cell
ACTTAAGACCACAA-1	T cell
ACTTAAGATTACTC-1	Monocyte
ACTTAGCTGCGTAT-1	Monocyte
ACTTAGCTGGGAGT-1	T cell
ACTTCAACAAGCAA-1	T cell
ACTTCAACGTAGGG-1	T cell
ACTTCCCTTTCCGC-1	T cell
ACTTCTGACATGCA-1	B cell
ACTTGACTCCACAA-1	B cell
ACTTGGGAGAAAGT-1	Monocyte
ACTTGGGAGGTTTG-1	T cell
ACTTGGGATGTGAC-1	Monocyte
ACTTGGGATTGACG-1	Monocyte
ACTTGTACCCGAAT-1	T cell
ACTTGTACCTGTCC-1	T cell
ACTTTGTGCGATAC-1	T cell
ACTTTGTGGAAAGT-1	T cell
ACTTTGTGGATAGA-1	Monocyte
AGAAACGAAAGTAG-1	B cell
AGAAAGTGCGCAAT-1	T cell
AGAAAGTGGGGATG-1	Monocyte
AGAACAGAAATGCC-1	NK cell
AGAACAGACGACTA-1	B cell
AGAACAGAGACAAA-1	T cell
AGAACGCTTTGCTT-1	T cell
AGAAGATGTGACTG-1	T cell
AGAATGGAAGAAGT-1	T cell
AGAATTTGTAACCG-1	T cell
AGAATTTGTAGAGA-1	T cell
AGACACACTGTAGC-1	T cell
AGACACTGTCAAGC-1	Monocyte
AGACCTGAAGTAGA-1	Monocyte
AGACCTGACCAACA-1	T cell
AGACCTGAGGAAGC-1	T cell
AGACGTACAGAGGC-1	T cell
AGACGTACCCCTAC-1	B cell
AGACGTACCTCTTA-1	Monocyte
AGACGTACTCGTGA-1	Monocyte
AGACTGACCATCAG-1	T cell
AGACTGACCCTTTA-1	T cell
AGACTTCTCATGCA-1	B cell
AGAGATGACAGTCA-1	T cell
AGAGATGACTGAAC-1	T cell
AGAGATGAGGTTTG-1	Monocyte
AGAGATGATCTCGC-1	B cell
AGAGATGATTGTGG-1	T cell
AGAGCGGAGGCAAG-1	Monocyte
AGAGGTCTACAGCT-1	T cell
AGAGTCTGGTCGTA-1	Monocyte
AGAGTGCTCAGCTA-1	T cell
AGAGTGCTCGAATC-1	B cell
AGAGTGCTGTCATG-1	T cell
AGAGTGCTGTCCTC-1	B cell
AGAGTGCTGTGTTG-1	B cell
AGATATACCCGTAA-1	NK cell
AGATATACGATGAA-1	T cell
AGATATACTGTTCT-1	B cell
AGATATTGCCTACC-1	T cell
AGATATTGGCCAAT-1	Monocyte
AGATCGTGTCTGGA-1	Monocyte
AGATCGTGTTTGTC-1	B cell
AGATCTCTATCACG-1	B cell
AGATTAACGTTCTT-1	Monocyte
AGATTCCTATCGTG-1	T cell
AGATTCCTCACTTT-1	Monocyte
AGATTCCTGACGAG-1	Monocyte
AGATTCCTGTTCAG-1	NK cell
AGCAAAGATATGCG-1	T cell
AGCACAACAGTCTG-1	T cell
AGCACTGAGGGAGT-1	T cell
AGCACTGATATGCG-1	T cell
AGCACTGATGCTTT-1	Monocyte
AGCACTGATTGCGA-1	T cell
AGCATCGAAGATCC-1	T cell
AGCATCGAAGGGTG-1	B cell
AGCATCGAGCTTCC-1	Monocyte
AGCATCGAGTGAGG-1	T cell
AGCATCGATAACCG-1	Monocyte
AGCATGACGATGAA-1	T cell
AGCCAATGGGGAGT-1	Monocyte
AGCCAATGTATCTC-1	T cell
AGCCACCTGGATCT-1	T cell
AGCCGGTGCCAATG-1	T cell
AGCCGGTGTGTTTC-1	T cell
AGCCGTCTCAATCG-1	T cell
AGCCGTCTGAGAGC-1	T cell
AGCCTCACGTTCGA-1	T cell
AGCCTCACTGTCAG-1	Monocyte
AGCCTCTGCAGTTG-1	B cell
AGCCTCTGCCAATG-1	T cell
AGCGAACTGGATCT-1	T cell
AGCGAACTTACTGG-1	T cell
AGCGATACGGAGCA-1	T cell
AGCGATTGAGATCC-1	T cell
AGCGCCGAATCTCT-1	T cell
AGCGCCGACAGAGG-1	T cell
AGCGCTCTACCTTT-1	T cell
AGCGGCACCGGGAA-1	T cell
AGCGGCTGATGTGC-1	T cell
AGCGGGCTTGCCAA-1	T cell
AGCGTAACATGCTG-1	T cell
AGCGTAACTGAGAA-1	Monocyte
AGCTCGCTACTGGT-1	B cell
AGCTCGCTCTGCTC-1	T cell
AGCTGAACCATACG-1	Monocyte
AGCTGAACCTCTCG-1	T cell
AGCTGCCTTGGGAG-1	Monocyte
AGCTGCCTTTCATC-1	T cell
AGCTGCCTTTCTGT-1	T cell
AGCTGTGATCCAAG-1	T cell
AGCTTTACAAGTAG-1	T cell
AGCTTTACACCAAC-1	T cell
AGCTTTACTCTCAT-1	B cell
AGGAAATGAGGAGC-1	T cell
AGGAACCTCTTAGG-1	Monocyte
AGGAACCTTGCCTC-1	T cell
AGGAATGATAACGC-1	T cell
AGGAATGATTTGTC-1	Monocyte
AGGAGTCTGGTTTG-1	T cell
AGGAGTCTTGTCAG-1	T cell
AGGATAGACATTTC-1	T cell
AGGATAGAGGATTC-1	T cell
AGGATGCTACTAGC-1	B cell
AGGATGCTTTAGGC-1	NK cell
AGGCAACTGAAGGC-1	T cell
AGGCAGGAGTACCA-1	T cell
AGGCCTCTAGTCGT-1	T cell
AGGCCTCTCGGAGA-1	T cell
AGGCCTCTCGTAAC-1	T cell
AGGGACGACGTTGA-1	T cell
AGGGACGAGTCAAC-1	NK cell
AGGGACGAGTTGTG-1	T cell
AGGGACGATAGAGA-1	T cell
AGGGACGATGCATG-1	T cell
AGGGAGTGAGCCTA-1	T cell
AGGGCCACCATACG-1	T cell
AGGGCGCTAACCAC-1	Monocyte
AGGGCGCTATGGTC-1	T cell
AGGGTGGACAGTCA-1	B cell
AGGGTGGACTCAAG-1	Monocyte
AGGGTGGAGTTGCA-1	T cell
AGGGTTTGTTCATC-1	Monocyte
AGGTCATGAGTGTC-1	B cell
AGGTCATGCTTATC-1	T cell
AGGTCTGATTCTCA-1	Monocyte
AGGTGGGAAGAATG-1	T cell
AGGTGGGAAGTTCG-1	T cell
AGGTGTTGGTTACG-1	B cell
AGGTTCGAACCTCC-1	Monocyte
AGGTTCGAACGTAC-1	Monocyte
AGGTTCGAGGGTGA-1	T cell
AGTAAGGAGTTTGG-1	T cell
AGTAAGGATTCTTG-1	Monocyte
AGTAATACATCACG-1	T cell
AGTAATACCGAACT-1	B cell
AGTAATTGTCCCAC-1	T cell
AGTACGTGAGGGTG-1	T cell
AGTACGTGCTGCAA-1	T cell
AGTACGTGCTTGGA-1	T cell
AGTACTCTACGTGT-1	B cell
AGTACTCTCAACCA-1	T cell
AGTACTCTCGGTAT-1	T cell
AGTAGGCTTGCCTC-1	Monocyte
AGTATAACTTGTCT-1	Monocyte
AGTATCCTAGAACA-1	T cell
AGTCACGATGAGCT-1	NK cell
AGTCAGACGAATAG-1	T cell
AGTCAGACGCTTAG-1	T cell
AGTCAGACTAGAGA-1	T cell
AGTCAGACTGCACA-1	T cell
AGTCCAGATATCTC-1	T cell
AGTCCAGATTTCAC-1	T cell
AGTCGAACCAACCA-1	T cell
AGTCGCCTCCGTAA-1	T cell
AGTCTACTAGGGTG-1	Monocyte
AGTCTACTTGCATG-1	Monocyte
AGTCTTACACCACA-1	T cell
AGTCTTACTTCGCC-1	T cell
AGTCTTACTTCGGA-1	Granulocyte
AGTGACTGCAACTG-1	Monocyte
AGTGTTCTAACCTG-1	T cell
AGTGTTCTATAAGG-1	T cell
AGTGTTCTCACTTT-1	Monocyte
AGTTAAACCACTTT-1	T cell
AGTTATGAACAGTC-1	Monocyte
AGTTATGACTGAGT-1	Monocyte
AGTTATGAGTTCAG-1	T cell
AGTTCTACCAGCTA-1	Monocyte
AGTTCTTGAAGCCT-1	B cell
AGTTGTCTACTACG-1	T cell
AGTTTAGATGGTCA-1	T cell
AGTTTCACGGTCTA-1	T cell
AGTTTGCTACAGTC-1	T cell
AGTTTGCTACTGGT-1	Monocyte
AGTTTGCTCCAAGT-1	T cell
ATAAACACAGTGCT-1	B cell
ATAAACACCACCAA-1	T cell
ATAACAACATGCTG-1	Monocyte
ATAACAACGTCTAG-1	T cell
ATAACAACTTTGTC-1	T cell
ATAACATGTACTCT-1	T cell
ATAACCCTGTTGGT-1	T cell
ATAACCCTTGGTAC-1	T cell
ATAAGTACGAATGA-1	B cell
ATAAGTTGGTACGT-1	Monocyte
ATAAGTTGTCTAGG-1	T cell
ATAATCGAGCTGAT-1	B cell
ATAATCGATGGTTG-1	T cell
ATAATGACCTACTT-1	T cell
ATAATGACTCGTGA-1	Monocyte
ATACAATGTTAGGC-1	T cell
ATACCACTCGTACA-1	Monocyte
ATACCACTCTAAGC-1	Monocyte
ATACCACTGCCAAT-1	T cell
ATACCGGAATGCTG-1	Monocyte
ATACCGGACATTTC-1	Monocyte
ATACCGGACTTCGC-1	T cell
ATACCGGAGGTGTT-1	Monocyte
ATACCGGATCTCGC-1	T cell
ATACCTACGCATCA-1	T cell
ATACCTTGGGGCAA-1	T cell
ATACGGACAGACTC-1	Granulocyte
ATACGGACCTACTT-1	Monocyte
ATACGGACGAGGTG-1	B cell
ATACGGACTATGCG-1	B cell
ATACGGACTCTGGA-1	Monocyte
ATACGTCTTAACGC-1	Monocyte
ATACTCTGCTTCGC-1	Monocyte
ATACTCTGGTATGC-1	Monocyte
ATAGATACCATGGT-1	T cell
ATAGATACGACGAG-1	T cell
ATAGATTGGTGTAC-1	B cell
ATAGCCGAACGGAG-1	T cell
ATAGCGTGCAGATC-1	T cell
ATAGCGTGCCCTTG-1	Monocyte
ATAGCGTGGTATCG-1	Monocyte
ATAGCGTGTCTCTA-1	T cell
ATAGCTCTCTGATG-1	T cell
ATAGCTCTGAGGTG-1	T cell
ATAGGAGAAACAGA-1	Monocyte
ATAGGCTGTCAGAC-1	T cell
ATAGTCCTAGTGTC-1	Monocyte
ATAGTCCTTGCATG-1	T cell
ATAGTCCTTGTCGA-1	T cell
ATAGTTGACAACTG-1	T cell
ATAGTTGACCCTCA-1	Monocyte
ATAGTTGAGACGTT-1	T cell
ATAGTTGATAAGCC-1	T cell
ATATACGAAGCCAT-1	T cell
ATATACGAATTGGC-1	B cell
ATATAGTGGAATGA-1	Granulocyte
ATATGCCTAGATCC-1	Monocyte
ATATGCCTGGACAG-1	T cell
ATATGCCTTCTCTA-1	T cell
ATATGCCTTGGTAC-1	T cell
ATCAAATGAGCCTA-1	Monocyte
ATCAAATGGGTAAA-1	Monocyte
ATCAACCTAAACGA-1	T cell
ATCAACCTGAGGAC-1	T cell
ATCAACCTTCTCTA-1	T cell
ATCAACCTTTGTCT-1	T cell
ATCACACTTTGTCT-1	T cell
ATCACGGATTGCTT-1	Monocyte
ATCACGGATTTCGT-1	B cell
ATCATCTGACACCA-1	T cell
ATCATGCTAGAGTA-1	B cell
ATCATGCTGAACCT-1	B cell
ATCCAGGACGCTAA-1	Monocyte
ATCCAGGATGGAAA-1	T cell
ATCCATACTCCTTA-1	Monocyte
ATCCATACTTCATC-1	Monocyte
ATCCCGTGCAGTCA-1	NK cell
ATCCCGTGCATGCA-1	B cell
ATCCCGTGGCTGAT-1	B cell
ATCCGCACGCATCA-1	B cell
ATCCTAACGACGGA-1	B cell
ATCCTAACGCTACA-1	T cell
ATCGACGAAACTGC-1	Monocyte
ATCGACGAATGACC-1	T cell
ATCGAGTGGACGTT-1	Monocyte
ATCGCAGAATCTCT-1	Monocyte
ATCGCAGAGTGTCA-1	B cell
ATCGCCACTGAGGG-1	T cell
ATCGCCTGGGTCAT-1	T cell
ATCGCCTGTGGCAT-1	B cell
ATCGCGCTCAGAGG-1	Granulocyte
ATCGCGCTGGGATG-1	B cell
ATCGCGCTTTTCGT-1	B cell
ATCGGAACCAGTCA-1	T cell
ATCGGTGAGTCAAC-1	T cell
ATCGGTGATTGCAG-1	T cell
ATCGTTTGCCTACC-1	B cell
ATCGTTTGGGTACT-1	Monocyte
ATCGTTTGTGCCAA-1	Monocyte
ATCTACACCCGCTT-1	Granulocyte
ATCTACACCGGGAA-1	T cell
ATCTCAACAGGAGC-1	B cell
ATCTCAACCTCGAA-1	T cell
ATCTCAACCTTGTT-1	Monocyte
ATCTGGGAAACCAC-1	Monocyte
ATCTGGGAAGTGTC-1	Monocyte
ATCTGGGATTCCGC-1	T cell
ATCTGTTGAACGGG-1	T cell
ATCTGTTGACCTCC-1	T cell
ATCTGTTGCCTTCG-1	Monocyte
ATCTGTTGGTTGCA-1	T cell
ATCTTGACACCAAC-1	T cell
ATCTTGACCTCCCA-1	Monocyte
ATCTTTCTGCATCA-1	NK cell
ATCTTTCTGTTTCT-1	T cell
ATCTTTCTTGTCCC-1	NK cell
ATGAAACTCTGTGA-1	T cell
ATGAAACTGAGGCA-1	T cell
ATGAAGGAACAGCT-1	T cell
ATGAAGGACCTGTC-1	B cell
ATGAAGGACCTTAT-1	B cell
ATGAAGGACTAGTG-1	B cell
ATGAAGGACTTGCC-1	T cell
ATGACGTGACGACT-1	B cell
ATGACGTGATCGGT-1	Monocyte
ATGAGAGAAAGTGA-1	T cell
ATGAGAGAACGCAT-1	T cell
ATGAGAGAAGTAGA-1	B cell
ATGAGCACACAGCT-1	T cell
ATGAGCACATCTTC-1	T cell
ATGATAACTTCACT-1	T cell
ATGATATGAAACAG-1	T cell
ATGATATGACTGGT-1	T cell
ATGATATGAGCACT-1	T cell
ATGATATGGTCATG-1	T cell
ATGATATGGTGCTA-1	NK cell
ATGATATGTTGTCT-1	T cell
ATGCACGAATGTCG-1	B cell
ATGCACGACTGTAG-1	T cell
ATGCACGAGAACCT-1	B cell
ATGCACGAGTTCGA-1	T cell
ATGCACGATTGGTG-1	Monocyte
ATGCAGTGTTACCT-1	B cell
ATGCAGTGTTCTAC-1	T cell
ATGCCAGAACGACT-1	T cell
ATGCCAGACAGTCA-1	Monocyte
ATGCCGCTTGAACC-1	Monocyte
ATGCGATGCTATGG-1	Monocyte
ATGCGATGCTGAGT-1	T cell
ATGCGATGGTTACG-1	B cell
ATGCGCCTTCATTC-1	T cell
ATGCTTTGCGAATC-1	T cell
ATGCTTTGGGCGAA-1	T cell
ATGCTTTGTAGTCG-1	B cell
ATGGACACATCGGT-1	T cell
ATGGACACGCATCA-1	NK cell
ATGGGTACAACCTG-1	B cell
ATGGGTACATCGGT-1	T cell
ATGGGTACTATTCC-1	T cell
ATGGGTACTGGGAG-1	T cell
ATGTAAACACCTCC-1	B cell
ATGTAAACCCGCTT-1	T cell
ATGTAAACGGGATG-1	Monocyte
ATGTAAACTCTCCG-1	T cell
ATGTAAACTTCACT-1	Monocyte
ATGTACCTCAGTCA-1	T cell
ATGTACCTTAGTCG-1	T cell
ATGTACCTTTATCC-1	Monocyte
ATGTACCTTTCACT-1	T cell
ATGTCACTAATGCC-1	Monocyte
ATGTCACTCTGCTC-1	T cell
ATGTCGGAGGTGAG-1	T cell
ATGTTCACAGTCTG-1	Monocyte
ATGTTCACCGTAGT-1	T cell
ATGTTGCTTTCAGG-1	T cell
ATTAACGATGAGAA-1	NK cell
ATTAACGATGCAAC-1	B cell
ATTAAGACTGCAGT-1	T cell
ATTACCTGCCTTAT-1	Monocyte
ATTACCTGGAGGAC-1	Monocyte
ATTACCTGGGCATT-1	B cell
ATTAGATGTTTCAC-1	T cell
ATTATGGAATCTCT-1	T cell
ATTCAAGAACGGGA-1	T cell
ATTCAAGACCTTTA-1	T cell
ATTCAGCTCATTGG-1	Monocyte
ATTCCAACCATTGG-1	Monocyte
ATTCCAACTTAGGC-1	T cell
ATTCGACTCACTAG-1	NK cell
ATTCGACTGAATAG-1	Monocyte
ATTCGACTTTTGTC-1	Monocyte
ATTCGGGAAAGGCG-1	Monocyte
ATTCGGGATTAGGC-1	T cell
ATTCTTCTGATACC-1	B cell
ATTGAATGGACGGA-1	T cell
ATTGATGAAGGTTC-1	T cell
ATTGATGACTGAGT-1	T cell
ATTGATGAGCGAAG-1	T cell
ATTGATGATCTATC-1	T cell
ATTGCACTGACGGA-1	T cell
ATTGCACTGAGAGC-1	Monocyte
ATTGCACTGGAGCA-1	Monocyte
ATTGCACTTAGCCA-1	T cell
ATTGCACTTGCTTT-1	Monocyte
ATTGCTTGTTACTC-1	B cell
ATTGGTCTGACTAC-1	B cell
ATTGGTCTTGTCTT-1	B cell
ATTGTAGATTCCCG-1	Monocyte
ATTGTAGATTGCAG-1	T cell
ATTGTCTGCGTACA-1	T cell
ATTTAGGAACCATG-1	Monocyte
ATTTAGGACAGAGG-1	T cell
ATTTCCGAGATGAA-1	T cell
ATTTCCGAGTGCTA-1	T cell
ATTTCGTGTATGGC-1	T cell
ATTTCTCTACTTTC-1	Monocyte
ATTTCTCTAGCAAA-1	T cell
ATTTCTCTCACTTT-1	Granulocyte
ATTTCTCTTCCCAC-1	T cell
ATTTGCACAAGATG-1	Monocyte
CAAAGCACAGCTCA-1	T cell
CAAAGCACCGTAAC-1	B cell
CAAAGCACGGTAAA-1	T cell
CAAAGCTGAAAGTG-1	T cell
CAAAGCTGTTGCTT-1	Monocyte
CAAATATGTGACAC-1	T cell
CAAATTGAGGGCAA-1	B cell
CAAATTGATGGAGG-1	Monocyte
CAACCAGAAAAGTG-1	T cell
CAACCAGAAGTGCT-1	T cell
CAACCAGAGTTCAG-1	Monocyte
CAACCAGATAGAAG-1	Monocyte
CAACCGCTGTTCAG-1	T cell
CAACCGCTTTGAGC-1	B cell
CAACGATGCGCAAT-1	Monocyte
CAACGTGACTCCAC-1	Monocyte
CAACGTGAGCCATA-1	NK cell
CAACGTGATCAAGC-1	Monocyte
CAAGAAGACCACAA-1	T cell
CAAGAAGACGTCTC-1	Monocyte
CAAGAAGATTCTAC-1	B cell
CAAGACTGACCTGA-1	B cell
CAAGACTGAGTAGA-1	B cell
CAAGCTGACCATAG-1	B cell
CAAGCTGATCTATC-1	T cell
CAAGGACTGTTCAG-1	T cell
CAAGGACTTCTTTG-1	T cell
CAAGGTTGCTCCAC-1	T cell
CAAGGTTGTCATTC-1	B cell
CAAGGTTGTCTGGA-1	T cell
CAAGTCGAAACAGA-1	B cell
CAAGTCGATAGCGT-1	Monocyte
CAATAAACGCCATA-1	B cell
CAATAATGAACTGC-1	Monocyte
CAATATGACATGGT-1	T cell
CAATATGACCTTCG-1	T cell
CAATATGACGTTAG-1	T cell
CAATATGAGGAGCA-1	T cell
CAATCGGAGAAACA-1	T cell
CAATCTACTGACTG-1	T cell
CAATTCACCCAACA-1	T cell
CAATTCACGATAGA-1	T cell
CAATTCACTTGTGG-1	B cell
CAATTCTGCTTGTT-1	Monocyte
CAATTCTGGCGTAT-1	Monocyte
CACAACGATACGAC-1	T cell
CACAATCTTGTTCT-1	T cell
CACAATCTTTCCAT-1	T cell
CACACCTGCTTGAG-1	T cell
CACACCTGTATGGC-1	T cell
CACAGAACCCTTGC-1	T cell
CACAGAACCTGATG-1	T cell
CACAGATGGGATTC-1	T cell
CACAGATGGTTTCT-1	Monocyte
CACAGCCTGATACC-1	T cell
CACAGCCTTGCCAA-1	Monocyte
CACAGCCTTGTAGC-1	T cell
CACAGTGATGAAGA-1	Monocyte
CACATACTACAGCT-1	NK cell
CACATGGAACACGT-1	T cell
CACATGGAAGTCGT-1	T cell
CACCACTGCCAACA-1	T cell
CACCACTGGCGAAG-1	T cell
CACCCATGTTCTGT-1	T cell
CACCGGGAATCGAC-1	T cell
CACCGGGACGAGAG-1	T cell
CACCGGGACGTGTA-1	T cell
CACCGGGACTTCTA-1	T cell
CACCGGGACTTGCC-1	NK cell
CACCGGGATTCGGA-1	T cell
CACCGTACTAAGGA-1	B cell
CACCGTACTAGCGT-1	T cell
CACCTGACACCCAA-1	T cell
CACCTGACCAGAAA-1	T cell
CACCTGACCTCAAG-1	T cell
CACCTGACGAAAGT-1	B cell
CACCTGACTCGTAG-1	T cell
CACGAAACTTCCGC-1	B cell
CACGACCTCGATAC-1	B cell
CACGCTACAGAAGT-1	T cell
CACGCTACTGTTCT-1	B cell
CACGCTACTTGACG-1	B cell
CACGGGACAGAGTA-1	T cell
CACGGGACATAAGG-1	T cell
CACGGGACGTAGGG-1	T cell
CACGGGTGCTTCGC-1	T cell
CACGGGTGGAGGAC-1	T cell
CACGGGTGTGTTTC-1	T cell
CACTAACTCCTAAG-1	B cell
CACTAACTGAAAGT-1	T cell
CACTAGGATGATGC-1	B cell
CACTATACCCCGTT-1	B cell
CACTATACGTTTGG-1	NK cell
CACTGAGACAGTCA-1	Granulocyte
CACTGCACTTCATC-1	T cell
CACTGCTGAGACTC-1	Monocyte
CACTGCTGGAAAGT-1	T cell
CACTTAACCGAATC-1	T cell
CACTTAACCGTACA-1	B cell
CACTTTGACTCTAT-1	T cell
CACTTTGAGCTGTA-1	T cell
CAGAAGCTCTCAAG-1	T cell
CAGACATGAACGGG-1	T cell
CAGACATGTCGACA-1	T cell
CAGACCCTAAGGTA-1	Monocyte
CAGACCCTAATGCC-1	T cell
CAGACCCTAGGAGC-1	T cell
CAGACTGAGTATGC-1	T cell
CAGATCGAATGTCG-1	B cell
CAGATCGACCTGAA-1	B cell
CAGATCGATATGGC-1	T cell
CAGATGACATTCTC-1	NK cell
CAGCAATGCCTTCG-1	T cell
CAGCAATGGAGGGT-1	NK cell
CAGCAATGGTGCTA-1	T cell
CAGCAATGTCTACT-1	Monocyte
CAGCAATGTGACCA-1	T cell
CAGCAATGTGAGGG-1	Monocyte
CAGCACCTAAGCCT-1	T cell
CAGCACCTAGGCGA-1	T cell
CAGCACCTGTAGGG-1	Monocyte
CAGCATGACAACCA-1	Monocyte
CAGCATGAGACGTT-1	T cell
CAGCCTACCCAACA-1	T cell
CAGCCTTGCTACCC-1	Monocyte
CAGCCTTGGGGACA-1	T cell
CAGCGGACACCCTC-1	T cell
CAGCGGACCTTTAC-1	NK cell
CAGCGTCTAAAGCA-1	T cell
CAGCGTCTTATCGG-1	T cell
CAGCTAGATGTGAC-1	B cell
CAGCTCTGAGGCGA-1	T cell
CAGCTCTGCAAGCT-1	T cell
CAGCTCTGTCGTAG-1	Monocyte
CAGCTCTGTGTGGT-1	NK cell
CAGGAACTAACTGC-1	T cell
CAGGAACTCTCAGA-1	Monocyte
CAGGCCGAACACCA-1	T cell
CAGGCCGAACACGT-1	T cell
CAGGCCGAACGACT-1	B cell
CAGGCCGAATCTCT-1	Monocyte
CAGGCCGACTAGCA-1	B cell
CAGGGCACCATACG-1	B cell
CAGGGCACCCAACA-1	T cell
CAGGGCACTCCCGT-1	T cell
CAGGTAACAGACTC-1	Monocyte
CAGGTATGAGTCGT-1	T cell
CAGGTATGTGCTTT-1	T cell
CAGGTTGAGGATCT-1	B cell
CAGTGATGGACGGA-1	B cell
CAGTGATGGCTAAC-1	T cell
CAGTGATGGGACAG-1	T cell
CAGTGATGTAAGGA-1	B cell
CAGTGATGTACGCA-1	B cell
CAGTGTGAACACGT-1	NK cell
CAGTGTGATGTCAG-1	T cell
CAGTTACTAAGGTA-1	B cell
CAGTTACTGATAGA-1	T cell
CAGTTGGAAAGAGT-1	Monocyte
CAGTTGGACATACG-1	T cell
CAGTTTACACACGT-1	T cell
CAGTTTACCCCAAA-1	T cell
CATAAAACGGAGCA-1	Monocyte
CATAAATGAACTGC-1	T cell
CATAACCTTCTCCG-1	T cell
CATACTACCTCGAA-1	T cell
CATACTACCTGAAC-1	T cell
CATACTACGTACCA-1	Monocyte
CATACTTGGGTTAC-1	Monocyte
CATAGTCTAATCGC-1	T cell
CATAGTCTCACTTT-1	T cell
CATATAGACTAAGC-1	Monocyte
CATATAGATCAGGT-1	B cell
CATCAACTAGAAGT-1	T cell
CATCAACTCCCTCA-1	T cell
CATCAGGACTTCCG-1	T cell
CATCAGGATAGCCA-1	NK cell
CATCAGGATCCTAT-1	Monocyte
CATCAGGATGCACA-1	Monocyte
CATCAGGATTTCGT-1	Monocyte
CATCATACCGCATA-1	Monocyte
CATCATACGGAGCA-1	B cell
CATCATACTCAAGC-1	T cell
CATCGCTGGGATCT-1	T cell
CATCGCTGTGGCAT-1	B cell
CATCGGCTATGCTG-1	T cell
CATCGGCTTTGGCA-1	T cell
CATCTCCTATGTGC-1	B cell
CATCTCCTCGAACT-1	B cell
CATGAGACACGGGA-1	B cell
CATGAGACGTTGAC-1	NK cell
CATGAGACTCGCCT-1	T cell
CATGCCACGGGTGA-1	T cell
CATGCCACTGCCAA-1	T cell
CATGCGCTAGTCAC-1	Monocyte
CATGCGCTCAGATC-1	Monocyte
CATGCGCTTTGCAG-1	Monocyte
CATGGCCTAGGGTG-1	Monocyte
CATGGCCTGTGCAT-1	T cell
CATGTACTATCGTG-1	T cell
CATGTTACAGTCGT-1	T cell
CATGTTACCTGAGT-1	T cell
CATGTTTGGGGATG-1	Granulocyte
CATTACACACGGAG-1	B cell
CATTACACCAACTG-1	NK cell
CATTACACGGAGTG-1	T cell
CATTACACTACTCT-1	T cell
CATTAGCTCCACAA-1	Monocyte
CATTGACTAGCGGA-1	Monocyte
CATTGGGACTCGAA-1	T cell
CATTGTACAGCGTT-1	T cell
CATTGTACTCGATG-1	B cell
CATTGTACTTATCC-1	T cell
CATTGTACTTTGCT-1	Monocyte
CATTGTTGCTAGTG-1	B cell
CATTTCGACTCTAT-1	T cell
CATTTCGAGATACC-1	NK cell
CATTTGACCACACA-1	T cell
CATTTGACCCTGAA-1	T cell
CATTTGTGACGACT-1	B cell
CATTTGTGCATTGG-1	T cell
CATTTGTGCGGAGA-1	T cell
CATTTGTGGGATCT-1	B cell
CCAAAGTGCTACGA-1	Monocyte
CCAAAGTGTGAGAA-1	Monocyte
CCAACCTGAAGTAG-1	T cell
CCAACCTGACGTAC-1	Monocyte
CCAACCTGTTCGCC-1	Monocyte
CCAAGAACCCAATG-1	T cell
CCAAGAACGTAGCT-1	T cell
CCAAGAACGTGTCA-1	T cell
CCAAGAACTACTGG-1	NK cell
CCAAGAACTCCTAT-1	B cell
CCAAGATGTCATTC-1	T cell
CCAAGATGTTTCAC-1	T cell
CCAAGTGAGGAACG-1	T cell
CCAAGTGATCAAGC-1	T cell
CCAATGGAACAGCT-1	NK cell
CCAATTTGAACGTC-1	Monocyte
CCACCATGAACGTC-1	T cell
CCACCATGATCGGT-1	T cell
CCACCATGGACGAG-1	Monocyte
CCACCATGGGGAGT-1	B cell
CCACCATGTCCTGC-1	T cell
CCACTGACCCGCTT-1	Monocyte
CCACTGTGGGAAGC-1	Monocyte
CCACTGTGTGTAGC-1	T cell
CCACTTCTCGGGAA-1	Monocyte
CCAGAAACCCTGTC-1	B cell
CCAGAAACGAACTC-1	T cell
CCAGAAACGGTCTA-1	T cell
CCAGACCTCTGAGT-1	Monocyte
CCAGACCTTGTGGT-1	B cell
CCAGCACTGCGATT-1	Monocyte
CCAGCGGAAAGGCG-1	Monocyte
CCAGCGGACGACTA-1	Monocyte
CCAGCGGATGGGAG-1	T cell
CCAGCTACACAGTC-1	T cell
CCAGCTACCAGCTA-1	B cell
CCAGGTCTACACCA-1	B cell
CCAGGTCTAGCATC-1	Monocyte
CCAGGTCTATGGTC-1	T cell
CCAGTCACACTGGT-1	Monocyte
CCAGTCACACTGTG-1	B cell
CCAGTCACGTTGTG-1	T cell
CCAGTCTGCGGAGA-1	B cell
CCAGTGCTAACCAC-1	T cell
CCAGTGCTCGTAGT-1	T cell
CCATCCGAAAGCAA-1	T cell
CCATCCGAACGACT-1	T cell
CCATCCGAAGGTTC-1	B cell
CCATCCGATTCGCC-1	Monocyte
CCATCGTGAACGGG-1	T cell
CCATCGTGCTAGAC-1	Monocyte
CCCAACACCTCGCT-1	B cell
CCCAACACGCATCA-1	T cell
CCCAACACTTTGTC-1	Monocyte
CCCAACTGCAATCG-1	Monocyte
CCCAGACTGCCTTC-1	Monocyte
CCCAGACTGGTTTG-1	B cell
CCCAGACTTTCGCC-1	Monocyte
CCCAGTTGCAGTTG-1	Monocyte
CCCAGTTGGGTACT-1	T cell
CCCAGTTGTCTATC-1	B cell
CCCGATTGTGTTTC-1	T cell
CCCGGAGAAGGGTG-1	Monocyte
CCCTACGAATTGGC-1	Monocyte
CCCTAGTGCAAAGA-1	T cell
CCCTCAGACACTTT-1	B cell
CCCTCAGACGAGAG-1	T cell
CCCTCAGAGGTCAT-1	T cell
CCCTGAACTAAAGG-1	B cell
CCCTGATGCAACCA-1	T cell
CCCTGATGCAAGCT-1	B cell
CCCTTACTAACCAC-1	Monocyte
CCCTTACTGCAGTT-1	T cell
CCGAAAACCTTGTT-1	Monocyte
CCGACACTGGTTTG-1	T cell
CCGACTACCCAGTA-1	Monocyte
CCGACTACCGTGTA-1	T cell
CCGACTACTGAGGG-1	T cell
CCGATAGACCTAAG-1	T cell
CCGATAGAGTTGGT-1	Monocyte
CCGCGAGACACACA-1	Monocyte
CCGCGAGAGGTTCA-1	T cell
CCGCTATGGGACGA-1	B cell
CCGCTATGTGCAAC-1	Monocyte
CCGCTATGTGCACA-1	Monocyte
CCGGTACTGTCCTC-1	T cell
CCGTACACAAGCAA-1	T cell
CCGTACACAGCGTT-1	B cell
CCGTACACGTCATG-1	T cell
CCGTACACGTTGGT-1	Monocyte
CCGTACACTAACGC-1	T cell
CCTAAACTTTCGTT-1	T cell
CCTAAGGACCCAAA-1	T cell
CCTAAGGACTAGCA-1	Monocyte
CCTAAGGAGGGCAA-1	T cell
CCTAAGGATGATGC-1	T cell
CCTAAGGATGTCAG-1	T cell
CCTACCGACTCTTA-1	T cell
CCTACCGAGGGATG-1	B cell
CCTAGAGAGGTGAG-1	B cell
CCTATAACCAAAGA-1	T cell
CCTATAACGAGACG-1	Monocyte
CCTATAACTCAGAC-1	T cell
CCTATAACTGCATG-1	Monocyte
CCTCGAACACTTTC-1	NK cell
CCTCGAACCCGTAA-1	Monocyte
CCTCGAACGTATCG-1	B cell
CCTCGAACTTACTC-1	T cell
CCTCTACTCTTCGC-1	Monocyte
CCTCTACTGGCATT-1	T cell
CCTGACTGAAGTAG-1	T cell
CCTGACTGGGGAGT-1	T cell
CCTGACTGTGTCTT-1	B cell
CCTGCAACACGTTG-1	Monocyte
CCTGGACTCGTGAT-1	T cell
CCTTAATGCCCAAA-1	B cell
CCTTAATGTTCTAC-1	Monocyte
CCTTCACTACGACT-1	T cell
CCTTCACTCAGTCA-1	B cell
CCTTCACTGGAGTG-1	Monocyte
CCTTTAGATTCATC-1	Monocyte
CGAACATGCCCTAC-1	Monocyte
CGAACATGTCAGAC-1	T cell
CGAAGACTGGAACG-1	T cell
CGAAGACTGTTACG-1	T cell
CGAAGGGAAACCTG-1	T cell
CGAAGGGATCCGAA-1	B cell
CGAAGTACCAACTG-1	B cell
CGAATCGAGGAGCA-1	NK cell
CGAATCGAGGAGGT-1	T cell
CGACAAACCCATAG-1	T cell
CGACAAACCGACAT-1	B cell
CGACCACTAAAGTG-1	T cell
CGACCACTGCCAAT-1	NK cell
CGACCGGAAGGTCT-1	T cell
CGACCGGATGGAAA-1	T cell
CGACCTTGCTAGTG-1	T cell
CGACCTTGGCAAGG-1	T cell
CGACGTCTATCGTG-1	T cell
CGACGTCTCGTGTA-1	T cell
CGACGTCTGAGGCA-1	T cell
CGACTCACGTCGTA-1	T cell
CGACTCACGTTGCA-1	T cell
CGACTCTGTGTGAC-1	T cell
CGACTGCTTCCTCG-1	B cell
CGAGAACTAAGGCG-1	T cell
CGAGAACTACGTTG-1	T cell
CGAGAACTTGTTCT-1	Monocyte
CGAGATTGGACACT-1	NK cell
CGAGATTGGCCATA-1	T cell
CGAGCCGAACACCA-1	T cell
CGAGCCGACGACAT-1	T cell
CGAGCCGAGGCGAA-1	T cell
CGAGCGTGCTCCAC-1	T cell
CGAGCGTGGATACC-1	T cell
CGAGCGTGTATGCG-1	B cell
CGAGGAGACCTCCA-1	B cell
CGAGGAGATGTCGA-1	T cell
CGAGGCACCTATGG-1	T cell
CGAGGCACTATGCG-1	Monocyte
CGAGGCACTCTTCA-1	T cell
CGAGGCTGACGCTA-1	T cell
CGAGGCTGGCAGTT-1	Monocyte
CGAGGGCTACGACT-1	B cell
CGAGGGCTCGAATC-1	T cell
CGAGTATGTCACCC-1	Monocyte
CGATACGAACAGTC-1	Monocyte
CGATACGACAGGAG-1	T cell
CGATACGATTCACT-1	B cell
CGATAGACCCGTAA-1	Granulocyte
CGATAGACCGTACA-1	T cell
CGATAGACGTAGGG-1	Monocyte
CGATAGACTGTTCT-1	T cell
CGATCAGAAGAACA-1	T cell
CGATCAGAGAGGGT-1	T cell
CGATCAGAGGTACT-1	T cell
CGATCAGATGTGAC-1	Monocyte
CGATCCACCGGGAA-1	T cell
CGATCCACTTCCAT-1	B cell
CGCAAATGCTCGAA-1	T cell
CGCAACCTCCTTGC-1	T cell
CGCAACCTGGACGA-1	T cell
CGCACGGAGGACGA-1	B cell
CGCACGGATCTTTG-1	T cell
CGCACTACAGAATG-1	T cell
CGCACTACAGCCAT-1	T cell
CGCACTACATTGGC-1	T cell
CGCACTACTCGCCT-1	B cell
CGCACTACTCGTGA-1	T cell
CGCACTTGTCACGA-1	Monocyte
CGCAGGACAGATCC-1	T cell
CGCAGGACCTACTT-1	T cell
CGCAGGACTTGTCT-1	Monocyte
CGCAGGTGCACTGA-1	T cell
CGCAGGTGCCATAG-1	Monocyte
CGCAGGTGGGAACG-1	T cell
CGCATAGATCACGA-1	Granulocyte
CGCCATACTGCAAC-1	T cell
CGCCATTGAGAGGC-1	T cell
CGCCATTGCTATGG-1	T cell
CGCCATTGGAGACG-1	T cell
CGCCATTGGAGCAG-1	B cell
CGCCATTGTACTGG-1	B cell
CGCCGAGAGCTTAG-1	T cell
CGCCTAACGAATGA-1	Monocyte
CGCCTAACTGCTCC-1	T cell
CGCGAGACACAGCT-1	T cell
CGCGAGACAGGTCT-1	B cell
CGCGAGACGCTACA-1	T cell
CGCGATCTCAGTCA-1	Monocyte
CGCGATCTGTTGAC-1	Monocyte
CGCGATCTTTCTTG-1	B cell
CGCGGATGGCCAAT-1	T cell
CGCTAAGAATGTCG-1	T cell
CGCTAAGACAACTG-1	T cell
CGCTAAGACCCTTG-1	T cell
CGCTACTGAACAGA-1	Monocyte
CGCTACTGAGAACA-1	T cell
CGCTACTGTGAGCT-1	T cell
CGCTACTGTTCCCG-1	NK cell
CGCTCATGCATTTC-1	Monocyte
CGGAATTGCACTAG-1	T cell
CGGAATTGGTTTGG-1	T cell
CGGAATTGTGGAGG-1	T cell
CGGACCGATGCGTA-1	T cell
CGGACCGATGGGAG-1	B cell
CGGACTCTAAACAG-1	B cell
CGGACTCTCCAATG-1	T cell
CGGACTCTCCTCGT-1	T cell
CGGAGGCTATTCCT-1	T cell
CGGAGGCTTGGATC-1	T cell
CGGATAACAACGAA-1	Monocyte
CGGATAACAGCTCA-1	T cell
CGGATAACTCAGTG-1	Monocyte
CGGCACGAACTCAG-1	B cell
CGGCACGAAGGGTG-1	T cell
CGGCACGACTACGA-1	Monocyte
CGGCATCTTAGAAG-1	T cell
CGGCATCTTCGTAG-1	Monocyte
CGGCCAGAAAGGTA-1	T cell
CGGCCAGAGAGGCA-1	T cell
CGGCGAACCAGTCA-1	Monocyte
CGGCGAACGACAAA-1	NK cell
CGGCGAACGGTCTA-1	T cell
CGGCGAACTACTTC-1	Monocyte
CGGGACTGCGTGTA-1	T cell
CGGGACTGGAATAG-1	T cell
CGGGCATGACCCAA-1	NK cell
CGGGCATGTCTCTA-1	T cell
CGGGCATGTTGTGG-1	T cell
CGGTAAACTCGCAA-1	T cell
CGGTCACTGTTTGG-1	T cell
CGGTCACTTACTTC-1	T cell
CGTAACGAATCAGC-1	T cell
CGTAACGATCGCCT-1	T cell
CGTACCACACACAC-1	T cell
CGTACCACACGTTG-1	T cell
CGTACCACCTCATT-1	T cell
CGTACCACGCTACA-1	T cell
CGTACCACGGAGCA-1	T cell
CGTACCTGGACGAG-1	Monocyte
CGTACCTGGCATCA-1	T cell
CGTAGCCTCTCTCG-1	Monocyte
CGTAGCCTGCGAAG-1	T cell
CGTAGCCTGTATGC-1	Monocyte
CGTCAAGAAAGGTA-1	Monocyte
CGTCAAGAACGTGT-1	T cell
CGTCAAGACAGAGG-1	T cell
CGTCAAGACAGGAG-1	T cell
CGTCCATGCTCTTA-1	T cell
CGTCGACTTTCCGC-1	T cell
CGTGATGACGCTAA-1	T cell
CGTGATGAGGTTCA-1	T cell
CGTGCACTTATGGC-1	Monocyte
CGTGTAGAAAAACG-1	T cell
CGTGTAGACGATAC-1	T cell
CGTGTAGAGTTACG-1	T cell
CGTGTAGAGTTCAG-1	Monocyte
CGTGTAGATTCGGA-1	T cell
CGTTAGGAAACCAC-1	T cell
CGTTAGGATCATTC-1	Monocyte
CGTTATACCCTGAA-1	T cell
CGTTTAACTGGTCA-1	T cell
CTAAACCTCTGACA-1	NK cell
CTAAACCTGTGCAT-1	B cell
CTAACACTAACGTC-1	T cell
CTAACACTAGTGCT-1	Monocyte
CTAACGGAACCGAT-1	T cell
CTAACGGATTTCTG-1	T cell
CTAACTACGGCAAG-1	T cell
CTAAGGACACCATG-1	T cell
CTAAGGACCGTTAG-1	T cell
CTAAGGACGCCATA-1	Monocyte
CTAAGGTGCCTAAG-1	B cell
CTAAGGTGTTGCAG-1	T cell
CTAAGGTGTTTCTG-1	T cell
CTAATAGAGCTATG-1	T cell
CTAATGCTTGTGGT-1	Monocyte
CTACAACTCCCGTT-1	T cell
CTACCTCTCAACCA-1	T cell
CTACGCACACCTAG-1	B cell
CTACGCACTCTCCG-1	T cell
CTACGCACTGGTCA-1	T cell
CTACGGCTTTCTTG-1	Monocyte
CTACTATGAACCAC-1	Monocyte
CTACTATGATGTGC-1	Monocyte
CTACTATGCTAAGC-1	T cell
CTACTATGTAAAGG-1	B cell
CTACTCCTATGTCG-1	NK cell
CTACTCCTGCCATA-1	Granulocyte
CTAGAGACACTTTC-1	T cell
CTAGAGACAGCATC-1	NK cell
CTAGAGACTTTGGG-1	Monocyte
CTAGATCTCTCTAT-1	T cell
CTAGATCTTCGACA-1	T cell
CTAGGATGAGCCTA-1	B cell
CTAGGATGATCGTG-1	B cell
CTAGGCCTCTCAGA-1	T cell
CTAGGTGATGGTTG-1	Monocyte
CTAGTTACCAGAGG-1	T cell
CTAGTTACCGCATA-1	T cell
CTAGTTACGAAACA-1	NK cell
CTAGTTTGAGTACC-1	T cell
CTATAAGATCGTTT-1	B cell
CTATACTGAGGTTC-1	Monocyte
CTATACTGCCAGTA-1	T cell
CTATACTGCGCTAA-1	Monocyte
CTATACTGCTACGA-1	NK cell
CTATACTGTCTCAT-1	T cell
CTATACTGTTCGTT-1	Monocyte
CTATAGCTGTCACA-1	T cell
CTATAGCTTCGCTC-1	Monocyte
CTATAGCTTGCCTC-1	Monocyte
CTATCAACGAACTC-1	T cell
CTATCAACGCAGAG-1	T cell
CTATCAACTTTGGG-1	T cell
CTATCCCTCCACCT-1	Monocyte
CTATGTACGAGAGC-1	T cell
CTATGTACGCTTAG-1	T cell
CTATGTACTGTTTC-1	T cell
CTATGTTGAAAGCA-1	T cell
CTATGTTGTCCTCG-1	B cell
CTATGTTGTCTCGC-1	T cell
CTATTGACAAACGA-1	B cell
CTATTGACACTGGT-1	Monocyte
CTATTGACGGTGAG-1	Monocyte
CTATTGTGGCAAGG-1	B cell
CTCAATTGGTTCAG-1	T cell
CTCAATTGGTTGCA-1	Monocyte
CTCAGAGATAGAAG-1	T cell
CTCAGCACTCTAGG-1	T cell
CTCAGCACTGAACC-1	B cell
CTCAGCACTTGCAG-1	T cell
CTCAGCTGAACCTG-1	T cell
CTCAGCTGCAGTTG-1	T cell
CTCAGCTGTTTCTG-1	T cell
CTCAGGCTCGTTGA-1	Monocyte
CTCAGGCTGCTAAC-1	T cell
CTCATTGACCTTAT-1	T cell
CTCATTGATGCTTT-1	Monocyte
CTCATTGATTGCTT-1	Monocyte
CTCCACGAGAGATA-1	Monocyte
CTCCATCTCTTAGG-1	T cell
CTCCATCTGACGAG-1	T cell
CTCCGAACAAGTGA-1	Monocyte
CTCCTACTGCCTTC-1	Monocyte
CTCGAAGATGTGGT-1	T cell
CTCGAAGATTAGGC-1	Monocyte
CTCGACTGCTCTAT-1	T cell
CTCGACTGGGTGAG-1	T cell
CTCGACTGGTTGAC-1	NK cell
CTCGAGCTCTGGAT-1	T cell
CTCGCATGACTTTC-1	T cell
CTCGCATGCTTAGG-1	T cell
CTCTAAACCTCGAA-1	T cell
CTCTAAACGGCGAA-1	T cell
CTCTAATGTCCAAG-1	B cell
CTGAACGACAGTCA-1	T cell
CTGAACGATGAGGG-1	T cell
CTGAAGACCCAACA-1	T cell
CTGAAGACGTGCAT-1	B cell
CTGAAGTGAAGCCT-1	Monocyte
CTGAAGTGCAGCTA-1	B cell
CTGAAGTGGCTATG-1	T cell
CTGAAGTGTCCAGA-1	T cell
CTGAATCTGAATAG-1	T cell
CTGACAGAATCGTG-1	T cell
CTGACCACAGCAAA-1	T cell
CTGAGAACCGGGAA-1	B cell
CTGAGAACGTAAAG-1	T cell
CTGATACTAGTAGA-1	T cell
CTGATTTGGTGTTG-1	Monocyte
CTGCAGCTAACCGT-1	T cell
CTGCAGCTGACACT-1	T cell
CTGCAGCTGGATTC-1	Monocyte
CTGCAGCTTGGCAT-1	T cell
CTGCCAACAGGAGC-1	T cell
CTGCCAACCAGCTA-1	T cell
CTGCCAACTAACCG-1	Monocyte
CTGCCAACTGCTCC-1	Monocyte
CTGCCAACTTGCAG-1	T cell
CTGCCAACTTGCTT-1	T cell
CTGCGACTCCACCT-1	T cell
CTGGAAACAAACGA-1	NK cell
CTGGAAACATCGAC-1	T cell
CTGGATGACTGGAT-1	T cell
CTGGATGACTTGTT-1	T cell
CTGGATGATGTGAC-1	B cell
CTGGCACTCAAGCT-1	Monocyte
CTGGCACTGGACAG-1	T cell
CTGTAACTAACCAC-1	T cell
CTGTAACTAGCGTT-1	T cell
CTGTATACGTAAAG-1	T cell
CTGTATACGTACGT-1	Monocyte
CTGTATACGTTGGT-1	T cell
CTGTGAGACAACCA-1	Monocyte
CTGTGAGACCTTGC-1	T cell
CTGTGAGACGAACT-1	Monocyte
CTGTGAGACTGTAG-1	Monocyte
CTTAAAGAACCTGA-1	T cell
CTTAACACCTGTAG-1	T cell
CTTAACACGAGCTT-1	T cell
CTTAACACTATCGG-1	B cell
CTTAAGCTACCTAG-1	T cell
CTTAAGCTAGTACC-1	T cell
CTTAAGCTCATCAG-1	T cell
CTTAAGCTCCGCTT-1	B cell
CTTAAGCTTCCTCG-1	T cell
CTTACAACTAACGC-1	T cell
CTTACAACTCCCGT-1	Monocyte
CTTACTGACGTACA-1	T cell
CTTAGACTAAACGA-1	NK cell
CTTAGGGACTTGCC-1	T cell
CTTAGGGAGAATCC-1	T cell
CTTATCGACTCATT-1	T cell
CTTCACCTACCTGA-1	Monocyte
CTTCATGAAGCATC-1	B cell
CTTCATGAAGTACC-1	T cell
CTTCATGACCGAAT-1	NK cell
CTTGAACTACGCAT-1	T cell
CTTGATTGAGGTTC-1	NK cell
CTTGATTGATCTTC-1	Monocyte
CTTGATTGCATTCT-1	B cell
CTTGATTGTTTCGT-1	T cell
CTTGTATGACACCA-1	B cell
CTTGTATGCGCAAT-1	B cell
CTTTACGAGCGAAG-1	T cell
CTTTAGACCGTGAT-1	T cell
CTTTAGACGAGACG-1	T cell
CTTTAGACGATACC-1	T cell
CTTTAGACGTTGGT-1	T cell
CTTTAGACTCATTC-1	T cell
CTTTAGTGACGGGA-1	T cell
CTTTAGTGGGTGGA-1	T cell
CTTTCAGAGAAACA-1	T cell
CTTTGATGAGCACT-1	T cell
CTTTGATGTCTAGG-1	T cell
CTTTGATGTGTCCC-1	T cell
CTTTGATGTGTGGT-1	B cell
GAAACAGAACTACG-1	T cell
GAAACAGAATCACG-1	T cell
GAAACAGACATTCT-1	T cell
GAAACCTGATCGTG-1	T cell
GAAACCTGATGCCA-1	T cell
GAAACCTGCTTATC-1	T cell
GAAACCTGGACTAC-1	Monocyte
GAAACCTGTGCTAG-1	T cell
GAAAGATGATTTCC-1	T cell
GAAAGATGCTGATG-1	Monocyte
GAAAGATGCTTCGC-1	Monocyte
GAAAGATGTAAGGA-1	Monocyte
GAAAGATGTTTGCT-1	T cell
GAAAGCCTACGTTG-1	B cell
GAAAGTGAAAGTGA-1	B cell
GAAAGTGACCACAA-1	Monocyte
GAAAGTGACTCAAG-1	T cell
GAAATACTACCAAC-1	B cell
GAAATACTCTTAGG-1	B cell
GAAATACTTCCTCG-1	T cell
GAACACACGTGCAT-1	Monocyte
GAACACACTGCCTC-1	T cell
GAACAGCTAACTGC-1	Monocyte
GAACAGCTCTCAGA-1	Monocyte
GAACCAACCACAAC-1	T cell
GAACCAACTTCCGC-1	T cell
GAACCTGAACGTGT-1	T cell
GAACCTGAGAGACG-1	T cell
GAACCTGATGAACC-1	T cell
GAACGGGATACTTC-1	T cell
GAACGTTGACGGAG-1	T cell
GAACTGTGACCTGA-1	Monocyte
GAACTGTGCCAGTA-1	Monocyte
GAAGAATGCAATCG-1	T cell
GAAGCGGACCTATT-1	Monocyte
GAAGCTACGAATGA-1	Monocyte
GAAGCTACGGTTTG-1	T cell
GAAGGGTGAAAGTG-1	T cell
GAAGGGTGCTTAGG-1	Monocyte
GAAGGTCTGAAAGT-1	T cell
GAAGGTCTGTTGCA-1	T cell
GAAGGTCTTAAAGG-1	Monocyte
GAAGTAGACTCCCA-1	T cell
GAAGTAGATCCAAG-1	Monocyte
GAAGTCACCCTCGT-1	Monocyte
GAAGTCACCCTGTC-1	B cell
GAAGTCTGTCGCAA-1	B cell
GAAGTCTGTTCTGT-1	T cell
GAAGTGCTAAACGA-1	T cell
GAAGTGCTCCGCTT-1	Monocyte
GAAGTGCTTAACCG-1	T cell
GAATGCACCCTAAG-1	T cell
GAATGCACCTTCGC-1	Monocyte
GAATGCTGCGGTAT-1	T cell
GAATGGCTAAGATG-1	T cell
GAATTAACGATAAG-1	B cell
GAATTAACGGTCAT-1	T cell
GAATTAACGTCGTA-1	NK cell
GAATTAACTGAAGA-1	B cell
GACAACACAGGCGA-1	T cell
GACAACACATCGTG-1	T cell
GACAACACTCGCCT-1	T cell
GACAACTGAGGTTC-1	T cell
GACAGGGAAGAGTA-1	B cell
GACAGGGAATGCCA-1	T cell
GACAGTACGAGCTT-1	Monocyte
GACAGTACTTCGGA-1	Monocyte
GACAGTTGAGTAGA-1	B cell
GACATTCTCCACCT-1	Monocyte
GACCAAACGACTAC-1	Monocyte
GACCAAACGTATCG-1	Monocyte
GACCATGACTCTCG-1	Monocyte
GACCCTACTAAAGG-1	B cell
GACCTAGACCTCAC-1	T cell
GACCTAGACGAGAG-1	T cell
GACCTCACAAGGTA-1	T cell
GACCTCACGTACGT-1	Monocyte
GACCTCTGCATCAG-1	T cell
GACGAACTCCCACT-1	T cell
GACGATTGCCAATG-1	B cell
GACGCCGACCTTCG-1	T cell
GACGCTCTCTCTCG-1	NK cell
GACGGCACACGGGA-1	NK cell
GACGGCACGAGATA-1	Monocyte
GACGTAACCTATGG-1	T cell
GACGTAACCTGTGA-1	T cell
GACGTAACTATGGC-1	T cell
GACGTATGTTGACG-1	T cell
GACGTATGTTTGCT-1	T cell
GACGTCCTACGGAG-1	T cell
GACGTCCTCTCAAG-1	Monocyte
GACGTCCTGATAAG-1	B cell
GACTACGATGGTCA-1	B cell
GACTCCTGCTCGCT-1	T cell
GACTCCTGGGTTAC-1	T cell
GACTCCTGTTATCC-1	T cell
GACTCCTGTTGGTG-1	Monocyte
GACTGAACAACCGT-1	B cell
GACTGAACCAATCG-1	Monocyte
GACTGATGTGATGC-1	T cell
GACTTTACATGCCA-1	T cell
GACTTTACGACAGG-1	B cell
GAGAAATGTTCTCA-1	B cell
GAGATAGAAAAAGC-1	Monocyte
GAGATCACGACAAA-1	Monocyte
GAGATGCTCTGGAT-1	T cell
GAGATGCTGAATGA-1	T cell
GAGCAGGATTCCCG-1	T cell
GAGCATACTTTGCT-1	Monocyte
GAGCGCACGCGTAT-1	Monocyte
GAGCGCACGGTGAG-1	T cell
GAGCGCTGAAGATG-1	T cell
GAGCGCTGTCTTAC-1	Monocyte
GAGCGGCTGGGAGT-1	B cell
GAGGACGACTCAGA-1	T cell
GAGGATCTGAAAGT-1	B cell
GAGGCAGACTTGCC-1	T cell
GAGGGAACACCAGT-1	T cell
GAGGGAACGAGGGT-1	T cell
GAGGGATGGGAAAT-1	T cell
GAGGGCCTTCACCC-1	T cell
GAGGGTGAAGAGTA-1	B cell
GAGGTACTACGGTT-1	T cell
GAGGTACTACTCAG-1	Monocyte
GAGGTACTGACACT-1	T cell
GAGGTACTGGGAGT-1	T cell
GAGGTACTTAGCGT-1	Monocyte
GAGGTGGAGTACGT-1	T cell
GAGGTGGATCCTCG-1	T cell
GAGGTTACTCGTTT-1	Monocyte
GAGGTTTGTAAGCC-1	Granulocyte
GAGTCAACCATTCT-1	T cell
GAGTCAACGGGAGT-1	T cell
GAGTCTGATCGTGA-1	T cell
GAGTCTGATTTGGG-1	B cell
GAGTGACTCAGCTA-1	T cell
GAGTGACTCGGTAT-1	T cell
GAGTGACTCTTGCC-1	B cell
GAGTGACTGACTAC-1	B cell
GAGTGACTGTCTAG-1	T cell
GAGTGGGAGTCTTT-1	B cell
GAGTGGGATGCCCT-1	T cell
GAGTGGGATGCTGA-1	B cell
GAGTGTTGCTGTAG-1	T cell
GAGTGTTGTGGTCA-1	T cell
GAGTTGTGCATGGT-1	Monocyte
GAGTTGTGCTGAGT-1	T cell
GAGTTGTGGCGAGA-1	Monocyte
GAGTTGTGGTAGCT-1	NK cell
GAGTTGTGTATGCG-1	Monocyte
GATAAGGAGAAACA-1	Monocyte
GATAAGGATTCACT-1	Monocyte
GATACTCTATCGGT-1	T cell
GATACTCTTACTTC-1	T cell
GATACTCTTGACTG-1	Monocyte
GATAGAGAAGGGTG-1	NK cell
GATAGAGACTGTGA-1	T cell
GATAGAGATCACGA-1	Monocyte
GATAGCACCCATAG-1	T cell
GATAGCACGAAGGC-1	Monocyte
GATAGCACTTGTCT-1	T cell
GATATAACAAGGTA-1	T cell
GATATAACACGCAT-1	T cell
GATATATGCTGGAT-1	B cell
GATATATGTCCGTC-1	T cell
GATATATGTGGAGG-1	Monocyte
GATATCCTAGAAGT-1	T cell
GATATCCTCCCGTT-1	Monocyte
GATATTGACAGGAG-1	T cell
GATATTGACGAGTT-1	Monocyte
GATATTGAGCCAAT-1	B cell
GATCCCTGACCTTT-1	T cell
GATCCCTGTGTAGC-1	T cell
GATCCGCTGGTCAT-1	Monocyte
GATCGAACCGAGAG-1	T cell
GATCGATGACTAGC-1	T cell
GATCGATGGTAAAG-1	B cell
GATCGATGTAAGGA-1	Monocyte
GATCGTGACACTAG-1	T cell
GATCGTGATTCACT-1	T cell
GATCTACTGGTGAG-1	T cell
GATCTACTTTGCAG-1	B cell
GATCTTACACCCAA-1	Monocyte
GATCTTACCCTACC-1	T cell
GATCTTACGAATAG-1	Monocyte
GATCTTACGAGATA-1	Monocyte
GATGCAACTCCAGA-1	T cell
GATGCCCTACGTAC-1	T cell
GATGCCCTCTCATT-1	T cell
GATGCCCTGGCAAG-1	Monocyte
GATGCCCTTTTGCT-1	T cell
GATTACCTTGTTCT-1	T cell
GATTCGGAACGACT-1	T cell
GATTCGGACAGGAG-1	Monocyte
GATTCGGAGAAGGC-1	Monocyte
GATTCTTGATTCGG-1	Monocyte
GATTCTTGCCGATA-1	T cell
GATTCTTGCGAGTT-1	B cell
GATTGGACCCGTTC-1	B cell
GATTGGACGGTGTT-1	B cell
GATTGGACTTTCGT-1	B cell
GATTGGTGTGTCAG-1	T cell
GATTTAGACACTCC-1	Monocyte
GATTTAGACTAAGC-1	B cell
GATTTAGATTCGTT-1	T cell
GATTTGCTAACGAA-1	T cell
GATTTGCTAACGGG-1	Granulocyte
GCAACCCTCCTCGT-1	B cell
GCAACTGATTGCGA-1	T cell
GCAAGACTACTGGT-1	T cell
GCAAGACTAGGTCT-1	T cell
GCAAGACTCCCTTG-1	T cell
GCAATCGACTGCAA-1	T cell
GCAATCGAGACGTT-1	Monocyte
GCAATCGATCCTTA-1	Monocyte
GCAATTCTCGTGTA-1	T cell
GCAATTCTTCTCCG-1	T cell
GCACAAACAATGCC-1	B cell
GCACAAACGGTACT-1	T cell
GCACAATGGTGCAT-1	Monocyte
GCACACCTGTGCTA-1	NK cell
GCACCACTCATGAC-1	B cell
GCACCACTGTTTGG-1	B cell
GCACCACTTCCTTA-1	NK cell
GCACCACTTTCGGA-1	Monocyte
GCACCTACGCGATT-1	T cell
GCACCTTGGCTGTA-1	T cell
GCACCTTGGGGAGT-1	Monocyte
GCACGGACCAGCTA-1	T cell
GCACGGTGACCTCC-1	T cell
GCACGGTGCTATGG-1	Monocyte
GCACTAGAACGGGA-1	T cell
GCACTAGAAGATGA-1	B cell
GCACTAGACCTTTA-1	Monocyte
GCACTAGACGTAAC-1	B cell
GCACTAGAGTCGTA-1	T cell
GCACTAGATGCAAC-1	T cell
GCACTGCTGAGGCA-1	T cell
GCAGATACAGCGTT-1	T cell
GCAGATACGACGGA-1	T cell
GCAGATACGCAGAG-1	T cell
GCAGCCGACAGTCA-1	T cell
GCAGCGTGCACTCC-1	T cell
GCAGCTCTCAATCG-1	T cell
GCAGCTCTGTTTCT-1	T cell
GCAGGGCTAAGAAC-1	T cell
GCAGGGCTAAGGGC-1	T cell
GCAGGGCTATCGAC-1	T cell
GCAGGGCTTGGGAG-1	T cell
GCAGTCCTAACTGC-1	T cell
GCAGTCCTCTCTTA-1	T cell
GCATCAGATGCGTA-1	T cell
GCATGTGACAAGCT-1	T cell
GCATTGGAGAAGGC-1	T cell
GCCAAAACGAGGCA-1	T cell
GCCAAATGATCGAC-1	T cell
GCCAACCTACGGTT-1	T cell
GCCAACCTCGCCTT-1	T cell
GCCACGGAGGCGAA-1	B cell
GCCACGGATACTGG-1	T cell
GCCACTACCTACTT-1	B cell
GCCACTACGTCTTT-1	T cell
GCCCAACTACCGAT-1	T cell
GCCCAACTATGGTC-1	NK cell
GCCCATACAGCGTT-1	T cell
GCCGACGAACTCTT-1	Monocyte
GCCGAGTGCGTTGA-1	T cell
GCCGGAACGAACTC-1	T cell
GCCGGAACGTTCTT-1	NK cell
GCCGGAACTGCACA-1	Monocyte
GCCGGAACTTACTC-1	T cell
GCCGTACTACCTGA-1	T cell
GCCGTACTGGCAAG-1	Monocyte
GCCTACACAGTTCG-1	NK cell
GCCTACACCACTGA-1	Monocyte
GCCTACACCTTGAG-1	T cell
GCCTAGCTACGGAG-1	B cell
GCCTAGCTCTATTC-1	T cell
GCCTAGCTTCTCAT-1	T cell
GCCTAGCTTCTCTA-1	Monocyte
GCCTCAACCATGGT-1	T cell
GCCTCAACTCTTTG-1	T cell
GCCTCATGTCTTAC-1	T cell
GCCTGACTCTCAAG-1	Monocyte
GCGAAGGAACTCTT-1	T cell
GCGAAGGAGAGCTT-1	T cell
GCGAAGGATGCCAA-1	T cell
GCGAGAGAGGGACA-1	T cell
GCGAGCACTGTCGA-1	T cell
GCGAGCACTTGACG-1	T cell
GCGAGCACTTGCTT-1	Monocyte
GCGATATGGTACGT-1	T cell
GCGATATGGTGTTG-1	T cell
GCGCACGAAGTCGT-1	T cell
GCGCACGACTTTAC-1	Monocyte
GCGCATCTAGGTCT-1	T cell
GCGCATCTGGTTAC-1	T cell
GCGCATCTTCGATG-1	T cell
GCGCATCTTGCTCC-1	T cell
GCGCATCTTTCTAC-1	T cell
GCGCGAACGTTCTT-1	B cell
GCGCGATGAACGGG-1	T cell
GCGCGATGGTGCAT-1	T cell
GCGGAGCTCCTGAA-1	T cell
GCGGCAACCCGATA-1	T cell
GCGGCAACGGAGGT-1	B cell
GCGGCAACTGTCGA-1	Monocyte
GCGTAAACACGGTT-1	Monocyte
GCGTAATGCACCAA-1	Monocyte
GCGTATGAACACCA-1	T cell
GCGTATGATGAGAA-1	Monocyte
GCTACAGAAAGGTA-1	T cell
GCTACAGAATCTTC-1	B cell
GCTACAGATCTTAC-1	T cell
GCTACCTGAGAAGT-1	Monocyte
GCTACCTGATCACG-1	T cell
GCTACGCTAGAATG-1	T cell
GCTACGCTAGCTAC-1	T cell
GCTACGCTCCCTAC-1	T cell
GCTAGAACAGAGGC-1	B cell
GCTAGAACGGATCT-1	T cell
GCTAGAACTCCCGT-1	T cell
GCTAGATGAGCTCA-1	Monocyte
GCTAGATGGCGATT-1	T cell
GCTATACTAAGGCG-1	T cell
GCTATACTAGCGTT-1	T cell
GCTATACTCTCTTA-1	T cell
GCTATACTGGACGA-1	T cell
GCTCAAGAACCATG-1	Monocyte
GCTCAAGAAGTCAC-1	Monocyte
GCTCAGCTGTCTAG-1	T cell
GCTCCATGAGAAGT-1	T cell
GCTCCATGCCGAAT-1	T cell
GCTCGACTCTAGTG-1	Monocyte
GCTGATGAGGTATC-1	Monocyte
GCTTAACTACAGTC-1	T cell
GCTTAACTACTGGT-1	T cell
GCTTAACTGCTGAT-1	T cell
GCTTAACTTAGACC-1	Monocyte
GCTTAACTTCAGTG-1	T cell
GGAACACTCACTTT-1	B cell
GGAACACTTCAGAC-1	Monocyte
GGAACTACTACTTC-1	T cell
GGAACTTGAAGGTA-1	Monocyte
GGAACTTGAGAATG-1	T cell
GGAACTTGCTCCAC-1	Monocyte
GGAACTTGGGTAGG-1	B cell
GGAAGGACATCGGT-1	Monocyte
GGAAGGACCACTAG-1	T cell
GGAAGGACGAGGGT-1	T cell
GGAAGGACGCGAAG-1	T cell
GGAAGGTGGCGAGA-1	NK cell
GGAATCTGAAGGGC-1	T cell
GGAATCTGAGGAGC-1	T cell
GGAATCTGCTTAGG-1	B cell
GGAATCTGCTTGTT-1	Monocyte
GGAATCTGGGAGGT-1	T cell
GGAATGCTTTCTAC-1	T cell
GGACAGGAAAGGGC-1	T cell
GGACAGGAGTGCTA-1	B cell
GGACAGGATCTCGC-1	T cell
GGACCCGAAGCTAC-1	Monocyte
GGACCGTGCTTACT-1	Monocyte
GGACCGTGGGAACG-1	B cell
GGACCGTGTAACGC-1	T cell
GGACCTCTGTAAGA-1	Monocyte
GGACCTCTTTTCTG-1	T cell
GGACGAGAGTGTCA-1	Monocyte
GGACGCTGACGCAT-1	T cell
GGACGCTGCTAGCA-1	T cell
GGACGCTGTCCTCG-1	NK cell
GGAGAGACGTGAGG-1	T cell
GGAGCAGATTCAGG-1	B cell
GGAGCCACCTTCTA-1	B cell
GGAGCGCTACGCAT-1	Monocyte
GGAGCGCTCCGAAT-1	T cell
GGAGGATGCCACCT-1	B cell
GGAGGATGGTTGAC-1	B cell
GGAGGATGTCAGTG-1	Monocyte
GGAGGCCTCGTTGA-1	T cell
GGAGGCCTTTCTTG-1	T cell
GGAGGTGATACGCA-1	T cell
GGAGGTGATCGCTC-1	T cell
GGATACTGCAGCTA-1	T cell
GGATACTGTCTAGG-1	B cell
GGATAGCTCGTCTC-1	T cell
GGATAGCTCTGAAC-1	T cell
GGATGTACCAAAGA-1	B cell
GGATGTACGCGAAG-1	T cell
GGATGTACGTCTTT-1	Monocyte
GGATGTACGTGTCA-1	T cell
GGATTTCTAGGTTC-1	T cell
GGATTTCTTTGTCT-1	Monocyte
GGCAAGGAAAAAGC-1	NK cell
GGCAAGGAAGAAGT-1	T cell
GGCAAGGACTTGGA-1	Monocyte
GGCAAGGAGGACTT-1	T cell
GGCAATACGCTAAC-1	B cell
GGCAATACGGCATT-1	NK cell
GGCAATACGTTTCT-1	B cell
GGCACGTGGCTTAG-1	Monocyte
GGCACGTGTGAGAA-1	B cell
GGCACTCTTTTGTC-1	T cell
GGCATATGCTTATC-1	NK cell
GGCATATGGGGAGT-1	Monocyte
GGCATATGTGTGAC-1	T cell
GGCCACGACAGAGG-1	B cell
GGCCAGACTGGTTG-1	T cell
GGCCCAGAAAGTAG-1	Monocyte
GGCCGAACAACGAA-1	T cell
GGCCGAACGCAGAG-1	T cell
GGCCGAACGTAGGG-1	T cell
GGCCGAACTCTAGG-1	NK cell
GGCCGATGCAGGAG-1	T cell
GGCCGATGCCGAAT-1	T cell
GGCCGATGTACTCT-1	T cell
GGCGACACTGCCCT-1	T cell
GGCGACTGCGTAAC-1	T cell
GGCGCATGCCTAAG-1	NK cell
GGCGCATGCTCCAC-1	T cell
GGCGCATGTGGAAA-1	T cell
GGCGGACTAGAGGC-1	T cell
GGCGGACTAGGAGC-1	T cell
GGCGGACTCTGACA-1	T cell
GGCGGACTCTTGGA-1	NK cell
GGCGGACTTACTGG-1	T cell
GGCGGACTTGAACC-1	T cell
GGCTAAACACCTGA-1	T cell
GGCTAAACTCTTAC-1	T cell
GGCTAATGAGCACT-1	T cell
GGCTAATGGTCTAG-1	T cell
GGCTCACTACTCAG-1	Monocyte
GGGAACGAAGCTCA-1	Monocyte
GGGAACGACACAAC-1	B cell
GGGAACGAGTGTCA-1	Monocyte
GGGAAGTGTTGAGC-1	Monocyte
GGGACCACACGTTG-1	T cell
GGGACCACAGAACA-1	T cell
GGGACCACGAATAG-1	T cell
GGGACCACGTCATG-1	T cell
GGGACCACTCAAGC-1	T cell
GGGACCACTCGTGA-1	T cell
GGGACCACTGCATG-1	T cell
GGGACCTGACCCTC-1	Monocyte
GGGACCTGCTTGCC-1	T cell
GGGACCTGTGGAGG-1	B cell
GGGATGGACGACAT-1	B cell
GGGATGGATACTTC-1	T cell
GGGATGGATGGTTG-1	Monocyte
GGGATTACGTCTAG-1	B cell
GGGCAAGATGCATG-1	Monocyte
GGGCACACGGTGAG-1	T cell
GGGCACACGTTGCA-1	T cell
GGGCAGCTTGGGAG-1	T cell
GGGCAGCTTTTCTG-1	T cell
GGGCCAACCTTGGA-1	B cell
GGGCCAACGCGTTA-1	B cell
GGGCCAACTACGCA-1	B cell
GGGCCAACTCCAAG-1	B cell
GGGCCATGATGGTC-1	Monocyte
GGGCCATGTTGACG-1	T cell
GGGTAACTCAGCTA-1	T cell
GGGTAACTCTAGTG-1	B cell
GGGTAACTCTGGAT-1	T cell
GGGTTAACGTGCAT-1	T cell
GGTAAAGAGCTAAC-1	T cell
GGTACAACTGCAAC-1	T cell
GGTACATGAAAGCA-1	B cell
GGTACATGAGCTCA-1	T cell
GGTACATGCGGTAT-1	T cell
GGTACATGGTTACG-1	T cell
GGTACATGTGGGAG-1	T cell
GGTACTGAACTCTT-1	Monocyte
GGTAGTACACCACA-1	T cell
GGTAGTACACTAGC-1	Monocyte
GGTAGTACCCTGTC-1	T cell
GGTAGTACGCCATA-1	Monocyte
GGTAGTACTGTCTT-1	T cell
GGTATCGAGACAAA-1	Monocyte
GGTATCGATGAACC-1	B cell
GGTCAAACCAAAGA-1	T cell
GGTCTAGAGAAACA-1	Monocyte
GGTCTAGATAGCGT-1	Monocyte
GGTGATACCGACTA-1	B cell
GGTGATACGACTAC-1	Granulocyte
GGTGATACTGTTTC-1	T cell
GGTGGAGAAACGGG-1	T cell
GGTGGAGAAGTAGA-1	T cell
GGTGGAGACAGATC-1	NK cell
GGTGGAGATCGATG-1	T cell
GGTGGAGATCTCTA-1	Monocyte
GGTGGAGATTACTC-1	T cell
GGTTTACTACGCAT-1	T cell
GTAACGTGACCTCC-1	Monocyte
GTAACGTGATCGGT-1	B cell
GTAACGTGCAGCTA-1	B cell
GTAACGTGGTTGAC-1	B cell
GTAAGCACAACGGG-1	T cell
GTAAGCACTCATTC-1	B cell
GTAAGCTGGTACCA-1	Monocyte
GTAATAACCTTCTA-1	Monocyte
GTAATAACGTTGTG-1	T cell
GTACCCTGACAGTC-1	Monocyte
GTACCCTGGAGCTT-1	T cell
GTACCCTGTCCTTA-1	T cell
GTACCCTGTGAACC-1	T cell
GTACGTGAACGTTG-1	NK cell
GTACTTTGTCGACA-1	T cell
GTAGACTGAGATGA-1	Monocyte
GTAGACTGTATTCC-1	T cell
GTAGCAACAGTCGT-1	Monocyte
GTAGCAACCATTTC-1	B cell
GTAGCAACGGTAGG-1	B cell
GTAGCATGCACTCC-1	B cell
GTAGCATGTAAGCC-1	Monocyte
GTAGCCCTGACGTT-1	T cell
GTAGCTGAAGCTAC-1	Monocyte
GTAGCTGAATTCGG-1	T cell
GTAGGTACACGGGA-1	Monocyte
GTAGTGACCTCATT-1	T cell
GTAGTGTGAGCGGA-1	NK cell
GTAGTGTGAGGCGA-1	B cell
GTAGTGTGTGGTTG-1	T cell
GTATCACTGGTAGG-1	Monocyte
GTATCTACAGAAGT-1	T cell
GTATCTACGACGAG-1	T cell
GTATCTACGTTACG-1	B cell
GTATTAGAAACAGA-1	T cell
GTATTAGAGGTCTA-1	T cell
GTATTCACACAGCT-1	T cell
GTATTCACGGGTGA-1	T cell
GTCAACGACACTGA-1	T cell
GTCAACGAGTGTAC-1	Monocyte
GTCAACGATCAGGT-1	NK cell
GTCAATCTACACCA-1	T cell
GTCAATCTGTAGCT-1	T cell
GTCAATCTTGTGGT-1	T cell
GTCACCTGCCTCCA-1	T cell
GTCACCTGTCCCGT-1	T cell
GTCATACTAATCGC-1	B cell
GTCATACTGCGATT-1	NK cell
GTCATACTTCGCCT-1	Monocyte
GTCATACTTTACCT-1	T cell
GTCATACTTTGACG-1	T cell
GTCCAAGAAAAACG-1	T cell
GTCCACTGACCTCC-1	T cell
GTCCACTGGGTACT-1	Monocyte
GTCCAGCTACGGGA-1	T cell
GTCCCATGTGGTGT-1	Monocyte
GTCGAATGAAGGCG-1	NK cell
GTCGACCTGAATGA-1	T cell
GTCGACCTGTTCAG-1	T cell
GTCGCACTTGAGAA-1	B cell
GTCTAACTGGTCTA-1	Monocyte
GTCTAGGAGCTTCC-1	Monocyte
GTGAACACACTCTT-1	T cell
GTGAACACAGATCC-1	T cell
GTGAACACTCAGGT-1	T cell
GTGACCCTTAAGCC-1	T cell
GTGATGACAAGTGA-1	T cell
GTGATGACCTGAGT-1	B cell
GTGATGACGGTTTG-1	T cell
GTGATTCTCATTTC-1	T cell
GTGATTCTCTCTCG-1	B cell
GTGATTCTGGTTCA-1	NK cell
GTGATTCTGTCGAT-1	T cell
GTGATTCTTAGCGT-1	B cell
GTGCCACTCAGGAG-1	B cell
GTGGATTGCACTAG-1	Monocyte
GTGGATTGCGGAGA-1	T cell
GTGGATTGTAACGC-1	T cell
GTGTACGATCAGTG-1	T cell
GTGTAGTGGGTACT-1	T cell
GTGTATCTAGCCTA-1	B cell
GTGTATCTAGTAGA-1	T cell
GTGTATCTGTTACG-1	B cell
GTGTCAGAAGCGTT-1	T cell
GTGTCAGAATGCTG-1	T cell
GTTAAAACCGAGAG-1	NK cell
GTTAAAACTTCGCC-1	T cell
GTTAAATGCTCGAA-1	T cell
GTTAAATGTCGACA-1	B cell
GTTAACCTAGCTAC-1	T cell
GTTAACCTTGCTTT-1	Monocyte
GTTAGGTGCACTCC-1	T cell
GTTAGGTGCCAGTA-1	Monocyte
GTTAGGTGCCCAAA-1	Monocyte
GTTAGGTGGAACTC-1	B cell
GTTAGTCTAAGAAC-1	T cell
GTTATAGAGGACAG-1	T cell
GTTATGCTTTCATC-1	T cell
GTTCAACTGGGACA-1	NK cell
GTTCAACTTATGCG-1	T cell
GTTGACGAGCCCTT-1	T cell
GTTGACGATATCGG-1	T cell
GTTGAGTGGTCTTT-1	Monocyte
GTTGAGTGTGCTTT-1	T cell
GTTGATCTGGGACA-1	T cell
GTTGATCTTTTCAC-1	T cell
GTTGGATGTTTACC-1	Monocyte
GTTGTACTATTCCT-1	Monocyte
GTTGTACTTTTGGG-1	T cell
GTTTAAGACCATGA-1	Monocyte
GTTTAAGACTGTCC-1	NK cell
TAAACAACCAACCA-1	T cell
TAAACAACGAATCC-1	B cell
TAAAGACTCAGGAG-1	T cell
TAAATCGATGAGGG-1	T cell
TAACAATGTGCCCT-1	T cell
TAACACCTTCGCTC-1	Monocyte
TAACACCTTCGTAG-1	Monocyte
TAACACCTTGTTTC-1	NK cell
TAACATGACACTAG-1	B cell
TAACCGGACTTACT-1	T cell
TAACGTCTCAACCA-1	Monocyte
TAACGTCTCATTGG-1	T cell
TAACTAGAATTTCC-1	T cell
TAACTAGACTTAGG-1	T cell
TAACTAGATCTGGA-1	T cell
TAACTCACGAGGAC-1	Monocyte
TAACTCACGTACAC-1	B cell
TAACTCACGTATCG-1	Monocyte
TAACTCACTCTACT-1	Monocyte
TAAGAACTGTGTCA-1	Monocyte
TAAGAGGACTAAGC-1	B cell
TAAGAGGACTTGTT-1	T cell
TAAGATACCCACAA-1	T cell
TAAGATACGGTTCA-1	Monocyte
TAAGATTGCGTAGT-1	T cell
TAAGATTGTTGCTT-1	T cell
TAAGCGTGAGGTTC-1	Monocyte
TAAGCGTGGACAAA-1	Monocyte
TAAGCGTGGGAAAT-1	T cell
TAAGCGTGTGCTCC-1	Monocyte
TAAGGCTGCCATGA-1	T cell
TAAGGCTGCTGCTC-1	T cell
TAAGGCTGTCTCGC-1	Monocyte
TAAGGGCTGCTGTA-1	T cell
TAAGGGCTTTACTC-1	T cell
TAAGTAACCGAGAG-1	B cell
TAAGTAACCTCCAC-1	B cell
TAAGTAACCTGTAG-1	T cell
TAAGTAACTTGTCT-1	T cell
TAATGATGAGCGGA-1	T cell
TAATGCCTCATGAC-1	T cell
TAATGCCTCGTCTC-1	T cell
TAATGTGAAGATGA-1	T cell
TAATGTGACTGCAA-1	Monocyte
TAATGTGATTACTC-1	T cell
TACAAATGGGTACT-1	T cell
TACAATGAAAACAG-1	Monocyte
TACAATGACTTAGG-1	T cell
TACAATGATGCTAG-1	T cell
TACACACTCACACA-1	T cell
TACACACTCTTACT-1	Monocyte
TACATAGAACGCAT-1	T cell
TACATCACACGGGA-1	T cell
TACATCACCTGTTT-1	Monocyte
TACATCACGCTAAC-1	B cell
TACATCACTGAACC-1	Monocyte
TACCATTGAGGTTC-1	T cell
TACCATTGCGGGAA-1	Monocyte
TACCATTGGGGATG-1	Monocyte
TACCATTGTGAGGG-1	T cell
TACCGGCTGTTGGT-1	T cell
TACGAGTGATCTCT-1	T cell
TACGAGTGATGCTG-1	Monocyte
TACGAGTGCGGAGA-1	T cell
TACGAGTGGTTGGT-1	T cell
TACGATCTAGTGTC-1	T cell
TACGATCTCACTGA-1	Monocyte
TACGATCTTACGAC-1	T cell
TACGCAGACGTCTC-1	B cell
TACGCAGAGAATCC-1	T cell
TACGCCACATTCCT-1	T cell
TACGCCACTCCCAC-1	Monocyte
TACGCCACTCCGAA-1	B cell
TACGCGCTCTTCTA-1	T cell
TACGGAACGCGTTA-1	B cell
TACGGCCTGGGACA-1	NK cell
TACGGCCTGTCCTC-1	T cell
TACGTACTACGGAG-1	T cell
TACGTACTCAGTTG-1	T cell
TACGTACTCCCGTT-1	B cell
TACGTTACAGAAGT-1	T cell
TACGTTACCAAGCT-1	Monocyte
TACTAAGAAAGGTA-1	B cell
TACTAAGAATCACG-1	T cell
TACTAAGATGATGC-1	Monocyte
TACTAAGATTGCGA-1	T cell
TACTACACGAGAGC-1	T cell
TACTACACTTACCT-1	T cell
TACTACTGAACCTG-1	Monocyte
TACTACTGATGTCG-1	T cell
TACTACTGATTCTC-1	T cell
TACTACTGTATGGC-1	T cell
TACTCAACGGTCTA-1	Monocyte
TACTCAACTGCTAG-1	B cell
TACTCCCTCAGTTG-1	T cell
TACTCTGAATCGAC-1	NK cell
TACTCTGACGAGTT-1	T cell
TACTCTGATTGACG-1	B cell
TACTGGGATCGATG-1	T cell
TACTGTTGAAAGCA-1	T cell
TACTGTTGAGGCGA-1	NK cell
TACTGTTGCTGAAC-1	B cell
TACTTGACTCCTCG-1	T cell
TACTTGACTGGTGT-1	B cell
TACTTTCTTTTGGG-1	T cell
TAGAAACTAATCGC-1	T cell
TAGAAACTGCTTCC-1	B cell
TAGAAACTGGGATG-1	NK cell
TAGAATTGCGACAT-1	T cell
TAGAATTGTATCGG-1	T cell
TAGACGTGCTTGAG-1	T cell
TAGACGTGTCGCTC-1	T cell
TAGAGCACCTTACT-1	B cell
TAGATTGACTTGTT-1	B cell
TAGATTGAGGCATT-1	T cell
TAGCATCTCAGCTA-1	NK cell
TAGCATCTCCCTCA-1	T cell
TAGCATCTGCTGTA-1	Monocyte
TAGCATCTGGGACA-1	T cell
TAGCATCTTGTCGA-1	T cell
TAGCCCACAAAAGC-1	T cell
TAGCCCACAGCCAT-1	T cell
TAGCCCACAGCTAC-1	T cell
TAGCCCACCCACAA-1	T cell
TAGCCCTGCGGAGA-1	T cell
TAGCCGCTTACGAC-1	T cell
TAGCCGCTTACTTC-1	T cell
TAGCCGCTTTCCAT-1	Monocyte
TAGCTACTGAATAG-1	B cell
TAGCTACTGTAGCT-1	T cell
TAGCTACTTTTGCT-1	T cell
TAGGACTGTGCTGA-1	T cell
TAGGAGCTAAGGCG-1	B cell
TAGGAGCTGAGGGT-1	T cell
TAGGAGCTTGCATG-1	B cell
TAGGCAACCGTCTC-1	T cell
TAGGCATGCTCTCG-1	Monocyte
TAGGCATGGCGAGA-1	T cell
TAGGCTGATGCCTC-1	Monocyte
TAGGGACTGAACTC-1	T cell
TAGGTCGACACTGA-1	T cell
TAGGTCGAGGATCT-1	B cell
TAGGTGACACACTG-1	T cell
TAGGTGACACGTTG-1	B cell
TAGGTGTGTTCTGT-1	T cell
TAGGTTCTGAAGGC-1	T cell
TAGGTTCTTCTTAC-1	Monocyte
TAGGTTCTTGCTGA-1	Monocyte
TAGTAAACCTCGCT-1	T cell
TAGTAAACGTCACA-1	T cell
TAGTAATGAGATCC-1	T cell
TAGTACCTAAGAAC-1	Monocyte
TAGTATGATCTTAC-1	B cell
TAGTATGATTCTCA-1	T cell
TAGTCTTGGCTGTA-1	T cell
TAGTCTTGGGACTT-1	T cell
TAGTCTTGTGGAAA-1	T cell
TAGTGGTGAAGTGA-1	NK cell
TAGTTAGAACCACA-1	NK cell
TAGTTAGATGAACC-1	T cell
TATAAGACAACAGA-1	T cell
TATAAGACAGCTCA-1	Monocyte
TATAAGTGACACCA-1	Monocyte
TATAAGTGTATCGG-1	Monocyte
TATAAGTGTGGTGT-1	Monocyte
TATACAGAACCCTC-1	T cell
TATACAGAAGAACA-1	T cell
TATACAGATCCAGA-1	T cell
TATACCACCTGATG-1	B cell
TATACGCTACCAAC-1	T cell
TATAGATGGACGGA-1	T cell
TATAGATGTTCCGC-1	Monocyte
TATCACTGACTGTG-1	Monocyte
TATCCAACCAGCTA-1	Monocyte
TATCCAACTCTCTA-1	T cell
TATCGACTACTAGC-1	T cell
TATCGACTCGATAC-1	Monocyte
TATCGTACAGATGA-1	T cell
TATCGTACATTCCT-1	Monocyte
TATCTCGAGAGATA-1	B cell
TATCTGACAGGTTC-1	T cell
TATCTGACTGTTTC-1	T cell
TATCTTCTAAACAG-1	T cell
TATGAATGGAGGAC-1	T cell
TATGAATGTTTGCT-1	Monocyte
TATGCGGATAACCG-1	T cell
TATGGGTGCATCAG-1	T cell
TATGGGTGCTAGCA-1	B cell
TATGGTCTCTACCC-1	T cell
TATGTCACGGAACG-1	B cell
TATGTCACTAACCG-1	Monocyte
TATGTCACTTCTCA-1	B cell
TATGTGCTCCGATA-1	B cell
TATGTGCTGGATTC-1	T cell
TATTGCTGAAGAAC-1	B cell
TATTGCTGCCGTTC-1	B cell
TATTGCTGTCTGGA-1	T cell
TATTGCTGTGCACA-1	NK cell
TATTTCCTATTGGC-1	Monocyte
TATTTCCTGGAGGT-1	NK cell
TATTTCCTGGTGTT-1	T cell
TCAACACTGTTTGG-1	T cell
TCAAGGACAGCGTT-1	T cell
TCAAGGACATTCTC-1	T cell
TCAAGGACGGTGTT-1	Monocyte
TCAATCACACTCTT-1	T cell
TCAATCACAGTCGT-1	Monocyte
TCACAACTATGTGC-1	T cell
TCACAACTTTGCTT-1	Monocyte
TCACATACACTTTC-1	T cell
TCACATACAGGGTG-1	T cell
TCACCCGAGACGGA-1	Monocyte
TCACCGTGCTCGCT-1	Monocyte
TCACCTCTACGACT-1	T cell
TCACCTCTTCCAAG-1	Monocyte
TCACGAGAGGAGGT-1	B cell
TCACTATGGGGCAA-1	T cell
TCACTATGGTTGTG-1	B cell
TCAGACGACGCTAA-1	T cell
TCAGACGACGTTAG-1	B cell
TCAGAGACTCCAGA-1	T cell
TCAGCAGACTCCAC-1	T cell
TCAGCGCTCTAGTG-1	NK cell
TCAGCGCTGGATCT-1	B cell
TCAGCGCTGGTATC-1	T cell
TCAGGATGAAGTAG-1	T cell
TCAGGATGCCTTTA-1	Monocyte
TCAGTGGAAGATCC-1	T cell
TCAGTTACCTACGA-1	Monocyte
TCAGTTACTAGAAG-1	T cell
TCATCAACCCGATA-1	T cell
TCATCAACTGTTCT-1	Monocyte
TCATCATGCAGTTG-1	T cell
TCATCCCTTACTGG-1	T cell
TCATTCGATACAGC-1	Monocyte
TCCACGTGGAAACA-1	T cell
TCCACTCTACACTG-1	T cell
TCCACTCTGAGCTT-1	Monocyte
TCCACTCTTACTTC-1	B cell
TCCATAACAAAGTG-1	T cell
TCCATAACCGTAGT-1	B cell
TCCATAACGATGAA-1	T cell
TCCATAACTACGCA-1	T cell
TCCATCCTCCCTAC-1	NK cell
TCCCACGATCATTC-1	T cell
TCCCATCTCAAAGA-1	Monocyte
TCCCGAACACAGTC-1	NK cell
TCCCGAACTTCGCC-1	Monocyte
TCCCGATGAGATCC-1	T cell
TCCCGATGCCTGAA-1	Monocyte
TCCCGATGCTGTGA-1	T cell
TCCCTACTCAACTG-1	B cell
TCCGAAGACAATCG-1	Monocyte
TCCGAAGACGTTAG-1	T cell
TCCGGACTGAGGTG-1	T cell
TCCGGACTGTACGT-1	T cell
TCCTAAACATCGAC-1	B cell
TCCTAAACCGAGAG-1	T cell
TCCTAAACCGCATA-1	NK cell
TCCTAATGGTTTGG-1	T cell
TCCTACCTGTCGTA-1	T cell
TCCTATGAAAAGCA-1	T cell
TCGAATCTCTGGTA-1	T cell
TCGACCTGCCGATA-1	Monocyte
TCGACGCTTCTATC-1	Monocyte
TCGACGCTTTGACG-1	T cell
TCGAGAACGACAGG-1	T cell
TCGAGAACGTTAGC-1	T cell
TCGAGCCTATCAGC-1	B cell
TCGAGCCTGCGAGA-1	T cell
TCGAGCCTTGTGAC-1	T cell
TCGATACTATTCCT-1	T cell
TCGATACTTGCACA-1	T cell
TCGATTTGATGCCA-1	Monocyte
TCGATTTGCACTCC-1	T cell
TCGATTTGCAGCTA-1	Monocyte
TCGATTTGCCTACC-1	Monocyte
TCGATTTGTCGTGA-1	B cell
TCGCACACCATCAG-1	Monocyte
TCGCAGCTAGATCC-1	T cell
TCGCCATGAGACTC-1	T cell
TCGCCATGTGGTCA-1	B cell
TCGGACCTAACAGA-1	T cell
TCGGACCTATAAGG-1	B cell
TCGGACCTGTACAC-1	T cell
TCGGTAGAGTAGGG-1	T cell
TCGGTAGATCCCAC-1	B cell
TCGTAGGATCGACA-1	T cell
TCGTGAGAACTGTG-1	B cell
TCGTTATGGACAAA-1	T cell
TCTAACACCAGTTG-1	NK cell
TCTAACACGAGCAG-1	Monocyte
TCTAACTGAACCAC-1	T cell
TCTAAGCTAATGCC-1	T cell
TCTAAGCTTAGTCG-1	T cell
TCTAAGCTTCTAGG-1	Monocyte
TCTAAGCTTGTTCT-1	Monocyte
TCTAAGCTTTCGCC-1	B cell
TCTACAACGACTAC-1	Monocyte
TCTAGACTTAGAAG-1	B cell
TCTAGTTGCACCAA-1	B cell
TCTATGTGAAGAGT-1	Monocyte
TCTATGTGAGTCTG-1	T cell
TCTCAAACCTAAGC-1	B cell
TCTCTAGAATTTCC-1	T cell
TCTGATACACGTGT-1	T cell
TCTGATACTCGCCT-1	B cell
TCTTACGAACCTGA-1	Monocyte
TCTTCAGAGCTACA-1	Monocyte
TCTTGATGCGGAGA-1	T cell
TGAAATTGGTGAGG-1	Monocyte
TGAACCGAAAACGA-1	T cell
TGAACCGACTACTT-1	Monocyte
TGAACCGATTCGGA-1	Monocyte
TGAAGCACTCACGA-1	T cell
TGAAGCTGAACGAA-1	T cell
TGAAGCTGAGACTC-1	B cell
TGAAGCTGCATGGT-1	B cell
TGAAGCTGCGTAAC-1	T cell
TGAATAACCACTTT-1	T cell
TGAATAACTCCCAC-1	T cell
TGACACGACCTTAT-1	B cell
TGACCAGACAACCA-1	T cell
TGACCAGAGGATTC-1	T cell
TGACCGCTAAAAGC-1	T cell
TGACCGCTCTGCAA-1	T cell
TGACGATGCAAAGA-1	Monocyte
TGACGCCTGTACCA-1	T cell
TGACGCCTTTACTC-1	T cell
TGACTGGAAGAGAT-1	Monocyte
TGACTGGACCGTAA-1	T cell
TGACTGGACGCAAT-1	T cell
TGACTGGAGGACAG-1	B cell
TGACTGGATTCTCA-1	T cell
TGACTTACACACCA-1	T cell
TGACTTACAGTCTG-1	Monocyte
TGACTTTGCGCATA-1	T cell
TGACTTTGTTTGTC-1	T cell
TGAGACACAAGGTA-1	T cell
TGAGACACTCAAGC-1	NK cell
TGAGACACTGTGCA-1	T cell
TGAGCTGAATGCTG-1	Monocyte
TGAGCTGACTGGAT-1	Monocyte
TGAGCTGAGCGAGA-1	T cell
TGAGCTGATGCTAG-1	Monocyte
TGAGGACTCTCATT-1	Monocyte
TGAGGACTTCATTC-1	T cell
TGAGGTACGAACCT-1	Monocyte
TGAGTCGAGTTACG-1	B cell
TGAGTGACTGAGCT-1	T cell
TGATAAACGAATCC-1	T cell
TGATAAACTCCGTC-1	T cell
TGATAAACTTTCAC-1	T cell
TGATACCTCACTAG-1	Monocyte
TGATACCTGTTGGT-1	T cell
TGATACCTTATGCG-1	T cell
TGATACCTTGAAGA-1	T cell
TGATATGAACCTTT-1	T cell
TGATCACTAGCATC-1	T cell
TGATCACTCTCGCT-1	T cell
TGATCACTTCTACT-1	B cell
TGATCGGACTGACA-1	Monocyte
TGATCGGAGGAGCA-1	B cell
TGATCGGATATGCG-1	B cell
TGATTAGACATTGG-1	T cell
TGATTAGATGACTG-1	B cell
TGATTAGATGCTAG-1	T cell
TGATTCACTATGCG-1	T cell
TGATTCACTGTCAG-1	B cell
TGATTCTGCCGAAT-1	T cell
TGATTCTGCTCTTA-1	T cell
TGCAAGTGAGAACA-1	T cell
TGCAAGTGGGTAGG-1	Monocyte
TGCAATCTTCAGGT-1	Monocyte
TGCACAGACGACAT-1	NK cell
TGCCAAGAGCAGTT-1	T cell
TGCCAAGATCTCTA-1	T cell
TGCCACTGAACGTC-1	T cell
TGCCACTGCGATAC-1	T cell
TGCCAGCTTGGCAT-1	T cell
TGCCCAACAGCAAA-1	T cell
TGCCCAACCGCATA-1	Monocyte
TGCCGACTCTCCCA-1	B cell
TGCGAAACAGTCAC-1	B cell
TGCGAAACGTTGCA-1	B cell
TGCGATGAACGGTT-1	T cell
TGCGATGACCTCGT-1	B cell
TGCGATGACTAGTG-1	T cell
TGCGATGACTGCTC-1	B cell
TGCGATGACTTGCC-1	B cell
TGCGATGAGTGCTA-1	Monocyte
TGCGCACTCTTGAG-1	Monocyte
TGCGTAGAATAAGG-1	Monocyte
TGCGTAGACGGGAA-1	B cell
TGCGTAGATGGTCA-1	Monocyte
TGCTAGGAAACCGT-1	T cell
TGCTAGGATAGTCG-1	T cell
TGCTATACGGTTCA-1	Monocyte
TGCTATACTGCTGA-1	T cell
TGCTGAGAGAGCAG-1	T cell
TGCTGAGATTATCC-1	T cell
TGGAAAGACTCTCG-1	B cell
TGGAAAGAGCGATT-1	T cell
TGGAAAGAGGTCAT-1	Monocyte
TGGAAAGATATGGC-1	T cell
TGGAACACAAACAG-1	NK cell
TGGAACACGCTAAC-1	T cell
TGGAAGCTCAGATC-1	T cell
TGGACCCTACACTG-1	Monocyte
TGGACCCTCATGGT-1	T cell
TGGACCCTGGTACT-1	Monocyte
TGGACTGAGTATGC-1	T cell
TGGAGACTATCAGC-1	Monocyte
TGGAGACTGAAACA-1	B cell
TGGAGACTTCAAGC-1	T cell
TGGAGACTTGACCA-1	T cell
TGGAGGGACGGAGA-1	Monocyte
TGGAGGGAGCTATG-1	T cell
TGGATCGATAAAGG-1	T cell
TGGATGTGACCTAG-1	B cell
TGGATGTGATGTCG-1	T cell
TGGATGTGTGAAGA-1	B cell
TGGATTCTCATACG-1	T cell
TGGCAATGCTTGTT-1	B cell
TGGCAATGGAGGGT-1	T cell
TGGCACCTTCACGA-1	NK cell
TGGCACCTTCAGTG-1	Monocyte
TGGGTATGAAGAGT-1	T cell
TGGGTATGCACAAC-1	T cell
TGGGTATGGTACGT-1	B cell
TGGGTATGTTTGGG-1	Monocyte
TGGTAGACATGCCA-1	T cell
TGGTAGACCCTCAC-1	NK cell
TGGTAGACCTGATG-1	T cell
TGGTAGTGCACTGA-1	Monocyte
TGGTATCTAAACAG-1	T cell
TGGTATCTCTTCCG-1	T cell
TGGTCAGACCCAAA-1	T cell
TGGTCAGACCGTTC-1	NK cell
TGGTTACTGACGTT-1	Monocyte
TGGTTACTGTTCTT-1	T cell
TGTAACCTAGAGGC-1	T cell
TGTAACCTTGCCTC-1	Monocyte
TGTAATGACACAAC-1	NK cell
TGTAATGAGGTAAA-1	T cell
TGTACTTGCTCTAT-1	Monocyte
TGTAGGTGCGAGAG-1	B cell
TGTAGGTGCTATGG-1	T cell
TGTAGGTGCTCTAT-1	Monocyte
TGTAGGTGTGCTGA-1	B cell
TGTAGTCTTCCAGA-1	T cell
TGTAGTCTTGCACA-1	T cell
TGTATCTGTTAGGC-1	T cell
TGTATGCTCATGGT-1	B cell
TGTATGCTGTAGGG-1	T cell
TGTATGCTTTCATC-1	T cell
TGTCAGGAATACCG-1	T cell
TGTCAGGAGATGAA-1	Monocyte
TGTCTAACCCCTTG-1	T cell
TGTGACGATTCTCA-1	T cell
TGTGAGACTGTCAG-1	T cell
TGTGAGACTTGAGC-1	T cell
TGTGAGTGACCACA-1	T cell
TGTGAGTGAGTGCT-1	Monocyte
TGTGAGTGGAGATA-1	T cell
TGTGATCTCTCTAT-1	B cell
TGTGATCTGACACT-1	T cell
TGTGGATGGCCAAT-1	B cell
TGTTAAGACAAAGA-1	Monocyte
TGTTAAGATAAGGA-1	Monocyte
TGTTAAGATTGGCA-1	Granulocyte
TGTTACACCGCATA-1	Monocyte
TGTTACACGACTAC-1	T cell
TGTTACTGGCTACA-1	T cell
TGTTACTGTAGTCG-1	T cell
TTAACCACCGTAAC-1	T cell
TTAACCACTAAGGA-1	T cell
TTAACCACTCAGAC-1	T cell
TTACACACGTGTTG-1	T cell
TTACACACTCCTAT-1	T cell
TTACCATGAATCGC-1	Monocyte
TTACCATGGTTGAC-1	T cell
TTACCATGTGTCTT-1	NK cell
TTACCATGTTGTGG-1	B cell
TTACGACTGAGAGC-1	T cell
TTACGACTTGACAC-1	Monocyte
TTACGTACGTTCAG-1	Monocyte
TTACTCGAACGTTG-1	T cell
TTACTCGAAGAATG-1	Monocyte
TTACTCGACGCAAT-1	Monocyte
TTACTCGAGGGTGA-1	T cell
TTACTCGATCTACT-1	NK cell
TTAGAATGTGGTGT-1	T cell
TTAGAATGTGTAGC-1	T cell
TTAGACCTCCTACC-1	T cell
TTAGACCTCCTTTA-1	Monocyte
TTAGCTACAACCGT-1	T cell
TTAGCTACTGTCCC-1	Monocyte
TTAGCTACTTTCGT-1	T cell
TTAGGGACGCGAAG-1	T cell
TTAGGGTGCTGGAT-1	B cell
TTAGGGTGTCCTGC-1	Monocyte
TTAGGTCTACTTTC-1	Monocyte
TTAGTCACCAGTTG-1	T cell
TTAGTCTGAAAGCA-1	B cell
TTAGTCTGCCAACA-1	NK cell
TTAGTCTGTGCACA-1	T cell
TTATCCGACTAGTG-1	B cell
TTATCCGAGAAAGT-1	Monocyte
TTATGAGAGATAAG-1	T cell
TTATGCACGTCACA-1	B cell
TTATGGCTTATGGC-1	B cell
TTATTCCTATGCTG-1	Monocyte
TTATTCCTGGACAG-1	B cell
TTATTCCTGGTACT-1	B cell
TTATTCCTTCGTGA-1	T cell
TTCAAAGATAAAGG-1	T cell
TTCAACACAACAGA-1	T cell
TTCAACACCCCAAA-1	Monocyte
TTCAACACGGACGA-1	Monocyte
TTCAAGCTAAGAAC-1	Monocyte
TTCAAGCTAGATGA-1	T cell
TTCAAGCTGTTGAC-1	T cell
TTCAAGCTTCCAAG-1	T cell
TTCAAGCTTGATGC-1	T cell
TTCAAGCTTTCGCC-1	T cell
TTCACAACCCGTTC-1	Monocyte
TTCACAACGTCTGA-1	Monocyte
TTCAGACTACCCAA-1	B cell
TTCAGACTCTCGAA-1	T cell
TTCAGTACCGACTA-1	T cell
TTCAGTACTCAAGC-1	T cell
TTCAGTACTCCTAT-1	Monocyte
TTCAGTTGCCAAGT-1	T cell
TTCAGTTGTCCTTA-1	Monocyte
TTCAGTTGTCTAGG-1	T cell
TTCAGTTGTCTCGC-1	T cell
TTCATCGAGGTGGA-1	Monocyte
TTCATGTGTGGTGT-1	T cell
TTCATTCTATGTCG-1	Monocyte
TTCATTCTTCTCTA-1	T cell
TTCCAAACCTATGG-1	Monocyte
TTCCAAACCTCCCA-1	B cell
TTCCAAACTCCCAC-1	NK cell
TTCCAAACTTGACG-1	T cell
TTCCATGACGAGAG-1	Monocyte
TTCCATGACTGTCC-1	T cell
TTCCCACTTGAGGG-1	B cell
TTCCCACTTGTCTT-1	Monocyte
TTCCTAGAAAGTGA-1	T cell
TTCCTAGACTAGTG-1	Monocyte
TTCGAGGACTCTAT-1	T cell
TTCGAGGAGGGCAA-1	T cell
TTCGAGGATAGAAG-1	Monocyte
TTCGATTGAGCATC-1	B cell
TTCGGAGAATGCCA-1	Monocyte
TTCGGAGATGTGCA-1	T cell
TTCGTATGAAAAGC-1	T cell
TTCGTATGGATAGA-1	T cell
TTCGTATGGTCTGA-1	T cell
TTCGTATGTCCTTA-1	Monocyte
TTCTACGAACGTAC-1	T cell
TTCTACGAGTTGGT-1	T cell
TTCTAGTGACACGT-1	T cell
TTCTAGTGCATGAC-1	Monocyte
TTCTAGTGGAGAGC-1	NK cell
TTCTAGTGGTCACA-1	Monocyte
TTCTCAGAAGAGAT-1	T cell
TTCTCAGAAGCATC-1	B cell
TTCTCAGATGGAGG-1	T cell
TTCTGATGGAGACG-1	Monocyte
TTCTTACTCTGGAT-1	Monocyte
TTGAACCTCCTTGC-1	B cell
TTGAATGAACTACG-1	NK cell
TTGAATGACTTACT-1	T cell
TTGAATGATCTCAT-1	B cell
TTGACACTCTGTAG-1	T cell
TTGACACTGATAAG-1	B cell
TTGAGGACAGAACA-1	Monocyte
TTGAGGACTACGCA-1	B cell
TTGAGGTGGACGGA-1	T cell
TTGCATTGAGCTAC-1	T cell
TTGCATTGCTAAGC-1	Monocyte
TTGCATTGTGACTG-1	T cell
TTGCTAACACCAAC-1	T cell
TTGCTAACACGCTA-1	Monocyte
TTGCTAACCACTCC-1	T cell
TTGCTATGGTACGT-1	Monocyte
TTGCTATGGTAGGG-1	Monocyte
TTGGAGACCAATCG-1	T cell
TTGGAGACGCTATG-1	Monocyte
TTGGAGACTATGGC-1	B cell
TTGGGAACTGAACC-1	T cell
TTGGTACTACTGGT-1	Monocyte
TTGGTACTCTTAGG-1	B cell
TTGGTACTGAATCC-1	B cell
TTGGTACTGGATTC-1	B cell
TTGTACACGTTGTG-1	B cell
TTGTACACTTGCAG-1	T cell
TTGTAGCTAGCTCA-1	T cell
TTGTAGCTCTCTTA-1	B cell
TTGTCATGGACGGA-1	NK cell
TTTAGAGATCCTCG-1	B cell
TTTAGCTGATACCG-1	T cell
TTTAGCTGGATACC-1	Monocyte
TTTAGCTGTACTCT-1	B cell
TTTAGGCTCCTTTA-1	Monocyte
TTTATCCTGTTGTG-1	Monocyte
TTTCACGAGGTTCA-1	T cell
TTTCAGTGGAAGGC-1	T cell
TTTCAGTGTCACGA-1	B cell
TTTCAGTGTCTATC-1	Monocyte
TTTCAGTGTGCAGT-1	B cell
TTTCCAGAGGTGAG-1	T cell
TTTCGAACACCTGA-1	B cell
TTTCGAACTCTCAT-1	Monocyte
TTTCTACTGAGGCA-1	B cell
TTTCTACTTCCTCG-1	B cell
TTTGCATGAGAGGC-1	B cell
TTTGCATGCCTCAC-1	T cell
